contig_150	NCBI; cellular organisms; Bacteria; Proteobacteria; Gammaproteobacteria; Pseudomonadales; Pseudomonadaceae; Pseudomonas; Pseudomonas aeruginosa group; Pseudomonas aeruginosa;
contig_167	NCBI; cellular organisms; Bacteria; Proteobacteria; Gammaproteobacteria; Enterobacterales; Enterobacteriaceae; Escherichia; Escherichia coli;
contig_37	NCBI; cellular organisms; Bacteria; Proteobacteria; Gammaproteobacteria; Enterobacterales; Enterobacteriaceae; Escherichia; Escherichia coli;
contig_645	NCBI; cellular organisms; Bacteria; Proteobacteria; Gammaproteobacteria; Enterobacterales; Enterobacteriaceae; Escherichia; Escherichia coli;
contig_689	NCBI; cellular organisms; Bacteria; Proteobacteria; Gammaproteobacteria; Enterobacterales; Enterobacteriaceae; Escherichia; Escherichia coli;
contig_550	NCBI; cellular organisms; Bacteria; Terrabacteria group; Firmicutes; Bacilli; Bacillales; Staphylococcaceae; Staphylococcus;
contig_169	NCBI; cellular organisms; Bacteria; Terrabacteria group; Firmicutes; Bacilli; Bacillales; Staphylococcaceae; Staphylococcus; Staphylococcus aureus;
contig_182	NCBI; cellular organisms; Bacteria; Terrabacteria group; Firmicutes; Bacilli; Bacillales; Staphylococcaceae; Staphylococcus; Staphylococcus aureus;
contig_505	NCBI; cellular organisms; Bacteria; Terrabacteria group; Firmicutes; Bacilli; Bacillales; Staphylococcaceae; Staphylococcus; Staphylococcus aureus;
contig_641	NCBI; cellular organisms; Bacteria; Terrabacteria group; Firmicutes; Bacilli; Bacillales; Staphylococcaceae; Staphylococcus; Staphylococcus aureus;
contig_81	NCBI; cellular organisms; Bacteria; Terrabacteria group; Firmicutes; Bacilli; Lactobacillales; Enterococcaceae; Enterococcus; Enterococcus faecalis;
contig_211	NCBI; cellular organisms; Bacteria; Terrabacteria group; Firmicutes; Bacilli; Lactobacillales; Lactobacillaceae; Limosilactobacillus; Limosilactobacillus fermentum;
contig_651	NCBI; cellular organisms; Bacteria; Terrabacteria group; Firmicutes; Bacilli; Lactobacillales; Lactobacillaceae; Limosilactobacillus; Limosilactobacillus fermentum;
contig_80	NCBI; cellular organisms; Bacteria; Terrabacteria group; Firmicutes; Bacilli; Bacillales; Listeriaceae; Listeria; Listeria monocytogenes;
contig_18	NCBI; cellular organisms; Eukaryota; Opisthokonta; Fungi; Dikarya; Ascomycota; saccharomyceta; Saccharomycotina; Saccharomycetes; Saccharomycetales; Saccharomycetaceae; Saccharomyces;
contig_190	NCBI; cellular organisms; Eukaryota; Opisthokonta; Fungi; Dikarya; Ascomycota; saccharomyceta; Saccharomycotina; Saccharomycetes; Saccharomycetales; Saccharomycetaceae; Saccharomyces;
contig_195	NCBI; cellular organisms; Eukaryota; Opisthokonta; Fungi; Dikarya; Ascomycota; saccharomyceta; Saccharomycotina; Saccharomycetes; Saccharomycetales; Saccharomycetaceae; Saccharomyces;
contig_29	NCBI; cellular organisms; Eukaryota; Opisthokonta; Fungi; Dikarya; Ascomycota; saccharomyceta; Saccharomycotina; Saccharomycetes; Saccharomycetales; Saccharomycetaceae; Saccharomyces;
contig_34	NCBI; cellular organisms; Eukaryota; Opisthokonta; Fungi; Dikarya; Ascomycota; saccharomyceta; Saccharomycotina; Saccharomycetes; Saccharomycetales; Saccharomycetaceae; Saccharomyces;
contig_606	NCBI; cellular organisms; Eukaryota; Opisthokonta; Fungi; Dikarya; Ascomycota; saccharomyceta; Saccharomycotina; Saccharomycetes; Saccharomycetales; Saccharomycetaceae; Saccharomyces;
contig_10	NCBI; cellular organisms; Eukaryota; Opisthokonta; Fungi; Dikarya; Ascomycota; saccharomyceta; Saccharomycotina; Saccharomycetes; Saccharomycetales; Saccharomycetaceae; Saccharomyces; Saccharomyces cerevisiae;
contig_11	NCBI; cellular organisms; Eukaryota; Opisthokonta; Fungi; Dikarya; Ascomycota; saccharomyceta; Saccharomycotina; Saccharomycetes; Saccharomycetales; Saccharomycetaceae; Saccharomyces; Saccharomyces cerevisiae;
contig_154	NCBI; cellular organisms; Eukaryota; Opisthokonta; Fungi; Dikarya; Ascomycota; saccharomyceta; Saccharomycotina; Saccharomycetes; Saccharomycetales; Saccharomycetaceae; Saccharomyces; Saccharomyces cerevisiae;
contig_155	NCBI; cellular organisms; Eukaryota; Opisthokonta; Fungi; Dikarya; Ascomycota; saccharomyceta; Saccharomycotina; Saccharomycetes; Saccharomycetales; Saccharomycetaceae; Saccharomyces; Saccharomyces cerevisiae;
contig_162	NCBI; cellular organisms; Eukaryota; Opisthokonta; Fungi; Dikarya; Ascomycota; saccharomyceta; Saccharomycotina; Saccharomycetes; Saccharomycetales; Saccharomycetaceae; Saccharomyces; Saccharomyces cerevisiae;
contig_165	NCBI; cellular organisms; Eukaryota; Opisthokonta; Fungi; Dikarya; Ascomycota; saccharomyceta; Saccharomycotina; Saccharomycetes; Saccharomycetales; Saccharomycetaceae; Saccharomyces; Saccharomyces cerevisiae;
contig_166	NCBI; cellular organisms; Eukaryota; Opisthokonta; Fungi; Dikarya; Ascomycota; saccharomyceta; Saccharomycotina; Saccharomycetes; Saccharomycetales; Saccharomycetaceae; Saccharomyces; Saccharomyces cerevisiae;
contig_168	NCBI; cellular organisms; Eukaryota; Opisthokonta; Fungi; Dikarya; Ascomycota; saccharomyceta; Saccharomycotina; Saccharomycetes; Saccharomycetales; Saccharomycetaceae; Saccharomyces; Saccharomyces cerevisiae;
contig_172	NCBI; cellular organisms; Eukaryota; Opisthokonta; Fungi; Dikarya; Ascomycota; saccharomyceta; Saccharomycotina; Saccharomycetes; Saccharomycetales; Saccharomycetaceae; Saccharomyces; Saccharomyces cerevisiae;
contig_183	NCBI; cellular organisms; Eukaryota; Opisthokonta; Fungi; Dikarya; Ascomycota; saccharomyceta; Saccharomycotina; Saccharomycetes; Saccharomycetales; Saccharomycetaceae; Saccharomyces; Saccharomyces cerevisiae;
contig_19	NCBI; cellular organisms; Eukaryota; Opisthokonta; Fungi; Dikarya; Ascomycota; saccharomyceta; Saccharomycotina; Saccharomycetes; Saccharomycetales; Saccharomycetaceae; Saccharomyces; Saccharomyces cerevisiae;
contig_196	NCBI; cellular organisms; Eukaryota; Opisthokonta; Fungi; Dikarya; Ascomycota; saccharomyceta; Saccharomycotina; Saccharomycetes; Saccharomycetales; Saccharomycetaceae; Saccharomyces; Saccharomyces cerevisiae;
contig_197	NCBI; cellular organisms; Eukaryota; Opisthokonta; Fungi; Dikarya; Ascomycota; saccharomyceta; Saccharomycotina; Saccharomycetes; Saccharomycetales; Saccharomycetaceae; Saccharomyces; Saccharomyces cerevisiae;
contig_20	NCBI; cellular organisms; Eukaryota; Opisthokonta; Fungi; Dikarya; Ascomycota; saccharomyceta; Saccharomycotina; Saccharomycetes; Saccharomycetales; Saccharomycetaceae; Saccharomyces; Saccharomyces cerevisiae;
contig_206	NCBI; cellular organisms; Eukaryota; Opisthokonta; Fungi; Dikarya; Ascomycota; saccharomyceta; Saccharomycotina; Saccharomycetes; Saccharomycetales; Saccharomycetaceae; Saccharomyces; Saccharomyces cerevisiae;
contig_207	NCBI; cellular organisms; Eukaryota; Opisthokonta; Fungi; Dikarya; Ascomycota; saccharomyceta; Saccharomycotina; Saccharomycetes; Saccharomycetales; Saccharomycetaceae; Saccharomyces; Saccharomyces cerevisiae;
contig_21	NCBI; cellular organisms; Eukaryota; Opisthokonta; Fungi; Dikarya; Ascomycota; saccharomyceta; Saccharomycotina; Saccharomycetes; Saccharomycetales; Saccharomycetaceae; Saccharomyces; Saccharomyces cerevisiae;
contig_22	NCBI; cellular organisms; Eukaryota; Opisthokonta; Fungi; Dikarya; Ascomycota; saccharomyceta; Saccharomycotina; Saccharomycetes; Saccharomycetales; Saccharomycetaceae; Saccharomyces; Saccharomyces cerevisiae;
contig_224	NCBI; cellular organisms; Eukaryota; Opisthokonta; Fungi; Dikarya; Ascomycota; saccharomyceta; Saccharomycotina; Saccharomycetes; Saccharomycetales; Saccharomycetaceae; Saccharomyces; Saccharomyces cerevisiae;
contig_225	NCBI; cellular organisms; Eukaryota; Opisthokonta; Fungi; Dikarya; Ascomycota; saccharomyceta; Saccharomycotina; Saccharomycetes; Saccharomycetales; Saccharomycetaceae; Saccharomyces; Saccharomyces cerevisiae;
contig_23	NCBI; cellular organisms; Eukaryota; Opisthokonta; Fungi; Dikarya; Ascomycota; saccharomyceta; Saccharomycotina; Saccharomycetes; Saccharomycetales; Saccharomycetaceae; Saccharomyces; Saccharomyces cerevisiae;
contig_24	NCBI; cellular organisms; Eukaryota; Opisthokonta; Fungi; Dikarya; Ascomycota; saccharomyceta; Saccharomycotina; Saccharomycetes; Saccharomycetales; Saccharomycetaceae; Saccharomyces; Saccharomyces cerevisiae;
contig_246	NCBI; cellular organisms; Eukaryota; Opisthokonta; Fungi; Dikarya; Ascomycota; saccharomyceta; Saccharomycotina; Saccharomycetes; Saccharomycetales; Saccharomycetaceae; Saccharomyces; Saccharomyces cerevisiae;
contig_25	NCBI; cellular organisms; Eukaryota; Opisthokonta; Fungi; Dikarya; Ascomycota; saccharomyceta; Saccharomycotina; Saccharomycetes; Saccharomycetales; Saccharomycetaceae; Saccharomyces; Saccharomyces cerevisiae;
contig_27	NCBI; cellular organisms; Eukaryota; Opisthokonta; Fungi; Dikarya; Ascomycota; saccharomyceta; Saccharomycotina; Saccharomycetes; Saccharomycetales; Saccharomycetaceae; Saccharomyces; Saccharomyces cerevisiae;
contig_28	NCBI; cellular organisms; Eukaryota; Opisthokonta; Fungi; Dikarya; Ascomycota; saccharomyceta; Saccharomycotina; Saccharomycetes; Saccharomycetales; Saccharomycetaceae; Saccharomyces; Saccharomyces cerevisiae;
contig_297	NCBI; cellular organisms; Eukaryota; Opisthokonta; Fungi; Dikarya; Ascomycota; saccharomyceta; Saccharomycotina; Saccharomycetes; Saccharomycetales; Saccharomycetaceae; Saccharomyces; Saccharomyces cerevisiae;
contig_3	NCBI; cellular organisms; Eukaryota; Opisthokonta; Fungi; Dikarya; Ascomycota; saccharomyceta; Saccharomycotina; Saccharomycetes; Saccharomycetales; Saccharomycetaceae; Saccharomyces; Saccharomyces cerevisiae;
contig_30	NCBI; cellular organisms; Eukaryota; Opisthokonta; Fungi; Dikarya; Ascomycota; saccharomyceta; Saccharomycotina; Saccharomycetes; Saccharomycetales; Saccharomycetaceae; Saccharomyces; Saccharomyces cerevisiae;
contig_31	NCBI; cellular organisms; Eukaryota; Opisthokonta; Fungi; Dikarya; Ascomycota; saccharomyceta; Saccharomycotina; Saccharomycetes; Saccharomycetales; Saccharomycetaceae; Saccharomyces; Saccharomyces cerevisiae;
contig_315	NCBI; cellular organisms; Eukaryota; Opisthokonta; Fungi; Dikarya; Ascomycota; saccharomyceta; Saccharomycotina; Saccharomycetes; Saccharomycetales; Saccharomycetaceae; Saccharomyces; Saccharomyces cerevisiae;
contig_32	NCBI; cellular organisms; Eukaryota; Opisthokonta; Fungi; Dikarya; Ascomycota; saccharomyceta; Saccharomycotina; Saccharomycetes; Saccharomycetales; Saccharomycetaceae; Saccharomyces; Saccharomyces cerevisiae;
contig_346	NCBI; cellular organisms; Eukaryota; Opisthokonta; Fungi; Dikarya; Ascomycota; saccharomyceta; Saccharomycotina; Saccharomycetes; Saccharomycetales; Saccharomycetaceae; Saccharomyces; Saccharomyces cerevisiae;
contig_386	NCBI; cellular organisms; Eukaryota; Opisthokonta; Fungi; Dikarya; Ascomycota; saccharomyceta; Saccharomycotina; Saccharomycetes; Saccharomycetales; Saccharomycetaceae; Saccharomyces; Saccharomyces cerevisiae;
contig_4	NCBI; cellular organisms; Eukaryota; Opisthokonta; Fungi; Dikarya; Ascomycota; saccharomyceta; Saccharomycotina; Saccharomycetes; Saccharomycetales; Saccharomycetaceae; Saccharomyces; Saccharomyces cerevisiae;
contig_401	NCBI; cellular organisms; Eukaryota; Opisthokonta; Fungi; Dikarya; Ascomycota; saccharomyceta; Saccharomycotina; Saccharomycetes; Saccharomycetales; Saccharomycetaceae; Saccharomyces; Saccharomyces cerevisiae;
contig_420	NCBI; cellular organisms; Eukaryota; Opisthokonta; Fungi; Dikarya; Ascomycota; saccharomyceta; Saccharomycotina; Saccharomycetes; Saccharomycetales; Saccharomycetaceae; Saccharomyces; Saccharomyces cerevisiae;
contig_432	NCBI; cellular organisms; Eukaryota; Opisthokonta; Fungi; Dikarya; Ascomycota; saccharomyceta; Saccharomycotina; Saccharomycetes; Saccharomycetales; Saccharomycetaceae; Saccharomyces; Saccharomyces cerevisiae;
contig_434	NCBI; cellular organisms; Eukaryota; Opisthokonta; Fungi; Dikarya; Ascomycota; saccharomyceta; Saccharomycotina; Saccharomycetes; Saccharomycetales; Saccharomycetaceae; Saccharomyces; Saccharomyces cerevisiae;
contig_435	NCBI; cellular organisms; Eukaryota; Opisthokonta; Fungi; Dikarya; Ascomycota; saccharomyceta; Saccharomycotina; Saccharomycetes; Saccharomycetales; Saccharomycetaceae; Saccharomyces; Saccharomyces cerevisiae;
contig_467	NCBI; cellular organisms; Eukaryota; Opisthokonta; Fungi; Dikarya; Ascomycota; saccharomyceta; Saccharomycotina; Saccharomycetes; Saccharomycetales; Saccharomycetaceae; Saccharomyces; Saccharomyces cerevisiae;
contig_503	NCBI; cellular organisms; Eukaryota; Opisthokonta; Fungi; Dikarya; Ascomycota; saccharomyceta; Saccharomycotina; Saccharomycetes; Saccharomycetales; Saccharomycetaceae; Saccharomyces; Saccharomyces cerevisiae;
contig_527	NCBI; cellular organisms; Eukaryota; Opisthokonta; Fungi; Dikarya; Ascomycota; saccharomyceta; Saccharomycotina; Saccharomycetes; Saccharomycetales; Saccharomycetaceae; Saccharomyces; Saccharomyces cerevisiae;
contig_571	NCBI; cellular organisms; Eukaryota; Opisthokonta; Fungi; Dikarya; Ascomycota; saccharomyceta; Saccharomycotina; Saccharomycetes; Saccharomycetales; Saccharomycetaceae; Saccharomyces; Saccharomyces cerevisiae;
contig_583	NCBI; cellular organisms; Eukaryota; Opisthokonta; Fungi; Dikarya; Ascomycota; saccharomyceta; Saccharomycotina; Saccharomycetes; Saccharomycetales; Saccharomycetaceae; Saccharomyces; Saccharomyces cerevisiae;
contig_584	NCBI; cellular organisms; Eukaryota; Opisthokonta; Fungi; Dikarya; Ascomycota; saccharomyceta; Saccharomycotina; Saccharomycetes; Saccharomycetales; Saccharomycetaceae; Saccharomyces; Saccharomyces cerevisiae;
contig_585	NCBI; cellular organisms; Eukaryota; Opisthokonta; Fungi; Dikarya; Ascomycota; saccharomyceta; Saccharomycotina; Saccharomycetes; Saccharomycetales; Saccharomycetaceae; Saccharomyces; Saccharomyces cerevisiae;
contig_586	NCBI; cellular organisms; Eukaryota; Opisthokonta; Fungi; Dikarya; Ascomycota; saccharomyceta; Saccharomycotina; Saccharomycetes; Saccharomycetales; Saccharomycetaceae; Saccharomyces; Saccharomyces cerevisiae;
contig_6	NCBI; cellular organisms; Eukaryota; Opisthokonta; Fungi; Dikarya; Ascomycota; saccharomyceta; Saccharomycotina; Saccharomycetes; Saccharomycetales; Saccharomycetaceae; Saccharomyces; Saccharomyces cerevisiae;
contig_603	NCBI; cellular organisms; Eukaryota; Opisthokonta; Fungi; Dikarya; Ascomycota; saccharomyceta; Saccharomycotina; Saccharomycetes; Saccharomycetales; Saccharomycetaceae; Saccharomyces; Saccharomyces cerevisiae;
contig_605	NCBI; cellular organisms; Eukaryota; Opisthokonta; Fungi; Dikarya; Ascomycota; saccharomyceta; Saccharomycotina; Saccharomycetes; Saccharomycetales; Saccharomycetaceae; Saccharomyces; Saccharomyces cerevisiae;
contig_614	NCBI; cellular organisms; Eukaryota; Opisthokonta; Fungi; Dikarya; Ascomycota; saccharomyceta; Saccharomycotina; Saccharomycetes; Saccharomycetales; Saccharomycetaceae; Saccharomyces; Saccharomyces cerevisiae;
contig_625	NCBI; cellular organisms; Eukaryota; Opisthokonta; Fungi; Dikarya; Ascomycota; saccharomyceta; Saccharomycotina; Saccharomycetes; Saccharomycetales; Saccharomycetaceae; Saccharomyces; Saccharomyces cerevisiae;
contig_626	NCBI; cellular organisms; Eukaryota; Opisthokonta; Fungi; Dikarya; Ascomycota; saccharomyceta; Saccharomycotina; Saccharomycetes; Saccharomycetales; Saccharomycetaceae; Saccharomyces; Saccharomyces cerevisiae;
contig_633	NCBI; cellular organisms; Eukaryota; Opisthokonta; Fungi; Dikarya; Ascomycota; saccharomyceta; Saccharomycotina; Saccharomycetes; Saccharomycetales; Saccharomycetaceae; Saccharomyces; Saccharomyces cerevisiae;
contig_652	NCBI; cellular organisms; Eukaryota; Opisthokonta; Fungi; Dikarya; Ascomycota; saccharomyceta; Saccharomycotina; Saccharomycetes; Saccharomycetales; Saccharomycetaceae; Saccharomyces; Saccharomyces cerevisiae;
contig_653	NCBI; cellular organisms; Eukaryota; Opisthokonta; Fungi; Dikarya; Ascomycota; saccharomyceta; Saccharomycotina; Saccharomycetes; Saccharomycetales; Saccharomycetaceae; Saccharomyces; Saccharomyces cerevisiae;
contig_663	NCBI; cellular organisms; Eukaryota; Opisthokonta; Fungi; Dikarya; Ascomycota; saccharomyceta; Saccharomycotina; Saccharomycetes; Saccharomycetales; Saccharomycetaceae; Saccharomyces; Saccharomyces cerevisiae;
contig_677	NCBI; cellular organisms; Eukaryota; Opisthokonta; Fungi; Dikarya; Ascomycota; saccharomyceta; Saccharomycotina; Saccharomycetes; Saccharomycetales; Saccharomycetaceae; Saccharomyces; Saccharomyces cerevisiae;
contig_7	NCBI; cellular organisms; Eukaryota; Opisthokonta; Fungi; Dikarya; Ascomycota; saccharomyceta; Saccharomycotina; Saccharomycetes; Saccharomycetales; Saccharomycetaceae; Saccharomyces; Saccharomyces cerevisiae;
contig_8	NCBI; cellular organisms; Eukaryota; Opisthokonta; Fungi; Dikarya; Ascomycota; saccharomyceta; Saccharomycotina; Saccharomycetes; Saccharomycetales; Saccharomycetaceae; Saccharomyces; Saccharomyces cerevisiae;
contig_9	NCBI; cellular organisms; Eukaryota; Opisthokonta; Fungi; Dikarya; Ascomycota; saccharomyceta; Saccharomycotina; Saccharomycetes; Saccharomycetales; Saccharomycetaceae; Saccharomyces; Saccharomyces cerevisiae;
contig_102	NCBI; cellular organisms; Eukaryota; Opisthokonta; Fungi; Dikarya; Basidiomycota; Agaricomycotina; Tremellomycetes; Tremellales; Cryptococcaceae; Cryptococcus; Cryptococcus neoformans species complex; Cryptococcus neoformans;
contig_125	NCBI; cellular organisms; Eukaryota; Opisthokonta; Fungi; Dikarya; Basidiomycota; Agaricomycotina; Tremellomycetes; Tremellales; Cryptococcaceae; Cryptococcus; Cryptococcus neoformans species complex; Cryptococcus neoformans;
contig_149	NCBI; cellular organisms; Eukaryota; Opisthokonta; Fungi; Dikarya; Basidiomycota; Agaricomycotina; Tremellomycetes; Tremellales; Cryptococcaceae; Cryptococcus; Cryptococcus neoformans species complex; Cryptococcus neoformans;
contig_171	NCBI; cellular organisms; Eukaryota; Opisthokonta; Fungi; Dikarya; Basidiomycota; Agaricomycotina; Tremellomycetes; Tremellales; Cryptococcaceae; Cryptococcus; Cryptococcus neoformans species complex; Cryptococcus neoformans;
contig_178	NCBI; cellular organisms; Eukaryota; Opisthokonta; Fungi; Dikarya; Basidiomycota; Agaricomycotina; Tremellomycetes; Tremellales; Cryptococcaceae; Cryptococcus; Cryptococcus neoformans species complex; Cryptococcus neoformans;
contig_186	NCBI; cellular organisms; Eukaryota; Opisthokonta; Fungi; Dikarya; Basidiomycota; Agaricomycotina; Tremellomycetes; Tremellales; Cryptococcaceae; Cryptococcus; Cryptococcus neoformans species complex; Cryptococcus neoformans;
contig_187	NCBI; cellular organisms; Eukaryota; Opisthokonta; Fungi; Dikarya; Basidiomycota; Agaricomycotina; Tremellomycetes; Tremellales; Cryptococcaceae; Cryptococcus; Cryptococcus neoformans species complex; Cryptococcus neoformans;
contig_188	NCBI; cellular organisms; Eukaryota; Opisthokonta; Fungi; Dikarya; Basidiomycota; Agaricomycotina; Tremellomycetes; Tremellales; Cryptococcaceae; Cryptococcus; Cryptococcus neoformans species complex; Cryptococcus neoformans;
contig_194	NCBI; cellular organisms; Eukaryota; Opisthokonta; Fungi; Dikarya; Basidiomycota; Agaricomycotina; Tremellomycetes; Tremellales; Cryptococcaceae; Cryptococcus; Cryptococcus neoformans species complex; Cryptococcus neoformans;
contig_201	NCBI; cellular organisms; Eukaryota; Opisthokonta; Fungi; Dikarya; Basidiomycota; Agaricomycotina; Tremellomycetes; Tremellales; Cryptococcaceae; Cryptococcus; Cryptococcus neoformans species complex; Cryptococcus neoformans;
contig_205	NCBI; cellular organisms; Eukaryota; Opisthokonta; Fungi; Dikarya; Basidiomycota; Agaricomycotina; Tremellomycetes; Tremellales; Cryptococcaceae; Cryptococcus; Cryptococcus neoformans species complex; Cryptococcus neoformans;
contig_208	NCBI; cellular organisms; Eukaryota; Opisthokonta; Fungi; Dikarya; Basidiomycota; Agaricomycotina; Tremellomycetes; Tremellales; Cryptococcaceae; Cryptococcus; Cryptococcus neoformans species complex; Cryptococcus neoformans;
contig_209	NCBI; cellular organisms; Eukaryota; Opisthokonta; Fungi; Dikarya; Basidiomycota; Agaricomycotina; Tremellomycetes; Tremellales; Cryptococcaceae; Cryptococcus; Cryptococcus neoformans species complex; Cryptococcus neoformans;
contig_212	NCBI; cellular organisms; Eukaryota; Opisthokonta; Fungi; Dikarya; Basidiomycota; Agaricomycotina; Tremellomycetes; Tremellales; Cryptococcaceae; Cryptococcus; Cryptococcus neoformans species complex; Cryptococcus neoformans;
contig_217	NCBI; cellular organisms; Eukaryota; Opisthokonta; Fungi; Dikarya; Basidiomycota; Agaricomycotina; Tremellomycetes; Tremellales; Cryptococcaceae; Cryptococcus; Cryptococcus neoformans species complex; Cryptococcus neoformans;
contig_218	NCBI; cellular organisms; Eukaryota; Opisthokonta; Fungi; Dikarya; Basidiomycota; Agaricomycotina; Tremellomycetes; Tremellales; Cryptococcaceae; Cryptococcus; Cryptococcus neoformans species complex; Cryptococcus neoformans;
contig_229	NCBI; cellular organisms; Eukaryota; Opisthokonta; Fungi; Dikarya; Basidiomycota; Agaricomycotina; Tremellomycetes; Tremellales; Cryptococcaceae; Cryptococcus; Cryptococcus neoformans species complex; Cryptococcus neoformans;
contig_230	NCBI; cellular organisms; Eukaryota; Opisthokonta; Fungi; Dikarya; Basidiomycota; Agaricomycotina; Tremellomycetes; Tremellales; Cryptococcaceae; Cryptococcus; Cryptococcus neoformans species complex; Cryptococcus neoformans;
contig_232	NCBI; cellular organisms; Eukaryota; Opisthokonta; Fungi; Dikarya; Basidiomycota; Agaricomycotina; Tremellomycetes; Tremellales; Cryptococcaceae; Cryptococcus; Cryptococcus neoformans species complex; Cryptococcus neoformans;
contig_238	NCBI; cellular organisms; Eukaryota; Opisthokonta; Fungi; Dikarya; Basidiomycota; Agaricomycotina; Tremellomycetes; Tremellales; Cryptococcaceae; Cryptococcus; Cryptococcus neoformans species complex; Cryptococcus neoformans;
contig_242	NCBI; cellular organisms; Eukaryota; Opisthokonta; Fungi; Dikarya; Basidiomycota; Agaricomycotina; Tremellomycetes; Tremellales; Cryptococcaceae; Cryptococcus; Cryptococcus neoformans species complex; Cryptococcus neoformans;
contig_245	NCBI; cellular organisms; Eukaryota; Opisthokonta; Fungi; Dikarya; Basidiomycota; Agaricomycotina; Tremellomycetes; Tremellales; Cryptococcaceae; Cryptococcus; Cryptococcus neoformans species complex; Cryptococcus neoformans;
contig_250	NCBI; cellular organisms; Eukaryota; Opisthokonta; Fungi; Dikarya; Basidiomycota; Agaricomycotina; Tremellomycetes; Tremellales; Cryptococcaceae; Cryptococcus; Cryptococcus neoformans species complex; Cryptococcus neoformans;
contig_261	NCBI; cellular organisms; Eukaryota; Opisthokonta; Fungi; Dikarya; Basidiomycota; Agaricomycotina; Tremellomycetes; Tremellales; Cryptococcaceae; Cryptococcus; Cryptococcus neoformans species complex; Cryptococcus neoformans;
contig_267	NCBI; cellular organisms; Eukaryota; Opisthokonta; Fungi; Dikarya; Basidiomycota; Agaricomycotina; Tremellomycetes; Tremellales; Cryptococcaceae; Cryptococcus; Cryptococcus neoformans species complex; Cryptococcus neoformans;
contig_276	NCBI; cellular organisms; Eukaryota; Opisthokonta; Fungi; Dikarya; Basidiomycota; Agaricomycotina; Tremellomycetes; Tremellales; Cryptococcaceae; Cryptococcus; Cryptococcus neoformans species complex; Cryptococcus neoformans;
contig_280	NCBI; cellular organisms; Eukaryota; Opisthokonta; Fungi; Dikarya; Basidiomycota; Agaricomycotina; Tremellomycetes; Tremellales; Cryptococcaceae; Cryptococcus; Cryptococcus neoformans species complex; Cryptococcus neoformans;
contig_296	NCBI; cellular organisms; Eukaryota; Opisthokonta; Fungi; Dikarya; Basidiomycota; Agaricomycotina; Tremellomycetes; Tremellales; Cryptococcaceae; Cryptococcus; Cryptococcus neoformans species complex; Cryptococcus neoformans;
contig_304	NCBI; cellular organisms; Eukaryota; Opisthokonta; Fungi; Dikarya; Basidiomycota; Agaricomycotina; Tremellomycetes; Tremellales; Cryptococcaceae; Cryptococcus; Cryptococcus neoformans species complex; Cryptococcus neoformans;
contig_328	NCBI; cellular organisms; Eukaryota; Opisthokonta; Fungi; Dikarya; Basidiomycota; Agaricomycotina; Tremellomycetes; Tremellales; Cryptococcaceae; Cryptococcus; Cryptococcus neoformans species complex; Cryptococcus neoformans;
contig_329	NCBI; cellular organisms; Eukaryota; Opisthokonta; Fungi; Dikarya; Basidiomycota; Agaricomycotina; Tremellomycetes; Tremellales; Cryptococcaceae; Cryptococcus; Cryptococcus neoformans species complex; Cryptococcus neoformans;
contig_347	NCBI; cellular organisms; Eukaryota; Opisthokonta; Fungi; Dikarya; Basidiomycota; Agaricomycotina; Tremellomycetes; Tremellales; Cryptococcaceae; Cryptococcus; Cryptococcus neoformans species complex; Cryptococcus neoformans;
contig_352	NCBI; cellular organisms; Eukaryota; Opisthokonta; Fungi; Dikarya; Basidiomycota; Agaricomycotina; Tremellomycetes; Tremellales; Cryptococcaceae; Cryptococcus; Cryptococcus neoformans species complex; Cryptococcus neoformans;
contig_364	NCBI; cellular organisms; Eukaryota; Opisthokonta; Fungi; Dikarya; Basidiomycota; Agaricomycotina; Tremellomycetes; Tremellales; Cryptococcaceae; Cryptococcus; Cryptococcus neoformans species complex; Cryptococcus neoformans;
contig_372	NCBI; cellular organisms; Eukaryota; Opisthokonta; Fungi; Dikarya; Basidiomycota; Agaricomycotina; Tremellomycetes; Tremellales; Cryptococcaceae; Cryptococcus; Cryptococcus neoformans species complex; Cryptococcus neoformans;
contig_376	NCBI; cellular organisms; Eukaryota; Opisthokonta; Fungi; Dikarya; Basidiomycota; Agaricomycotina; Tremellomycetes; Tremellales; Cryptococcaceae; Cryptococcus; Cryptococcus neoformans species complex; Cryptococcus neoformans;
contig_378	NCBI; cellular organisms; Eukaryota; Opisthokonta; Fungi; Dikarya; Basidiomycota; Agaricomycotina; Tremellomycetes; Tremellales; Cryptococcaceae; Cryptococcus; Cryptococcus neoformans species complex; Cryptococcus neoformans;
contig_409	NCBI; cellular organisms; Eukaryota; Opisthokonta; Fungi; Dikarya; Basidiomycota; Agaricomycotina; Tremellomycetes; Tremellales; Cryptococcaceae; Cryptococcus; Cryptococcus neoformans species complex; Cryptococcus neoformans;
contig_412	NCBI; cellular organisms; Eukaryota; Opisthokonta; Fungi; Dikarya; Basidiomycota; Agaricomycotina; Tremellomycetes; Tremellales; Cryptococcaceae; Cryptococcus; Cryptococcus neoformans species complex; Cryptococcus neoformans;
contig_413	NCBI; cellular organisms; Eukaryota; Opisthokonta; Fungi; Dikarya; Basidiomycota; Agaricomycotina; Tremellomycetes; Tremellales; Cryptococcaceae; Cryptococcus; Cryptococcus neoformans species complex; Cryptococcus neoformans;
contig_417	NCBI; cellular organisms; Eukaryota; Opisthokonta; Fungi; Dikarya; Basidiomycota; Agaricomycotina; Tremellomycetes; Tremellales; Cryptococcaceae; Cryptococcus; Cryptococcus neoformans species complex; Cryptococcus neoformans;
contig_442	NCBI; cellular organisms; Eukaryota; Opisthokonta; Fungi; Dikarya; Basidiomycota; Agaricomycotina; Tremellomycetes; Tremellales; Cryptococcaceae; Cryptococcus; Cryptococcus neoformans species complex; Cryptococcus neoformans;
contig_45	NCBI; cellular organisms; Eukaryota; Opisthokonta; Fungi; Dikarya; Basidiomycota; Agaricomycotina; Tremellomycetes; Tremellales; Cryptococcaceae; Cryptococcus; Cryptococcus neoformans species complex; Cryptococcus neoformans;
contig_451	NCBI; cellular organisms; Eukaryota; Opisthokonta; Fungi; Dikarya; Basidiomycota; Agaricomycotina; Tremellomycetes; Tremellales; Cryptococcaceae; Cryptococcus; Cryptococcus neoformans species complex; Cryptococcus neoformans;
contig_452	NCBI; cellular organisms; Eukaryota; Opisthokonta; Fungi; Dikarya; Basidiomycota; Agaricomycotina; Tremellomycetes; Tremellales; Cryptococcaceae; Cryptococcus; Cryptococcus neoformans species complex; Cryptococcus neoformans;
contig_453	NCBI; cellular organisms; Eukaryota; Opisthokonta; Fungi; Dikarya; Basidiomycota; Agaricomycotina; Tremellomycetes; Tremellales; Cryptococcaceae; Cryptococcus; Cryptococcus neoformans species complex; Cryptococcus neoformans;
contig_473	NCBI; cellular organisms; Eukaryota; Opisthokonta; Fungi; Dikarya; Basidiomycota; Agaricomycotina; Tremellomycetes; Tremellales; Cryptococcaceae; Cryptococcus; Cryptococcus neoformans species complex; Cryptococcus neoformans;
contig_487	NCBI; cellular organisms; Eukaryota; Opisthokonta; Fungi; Dikarya; Basidiomycota; Agaricomycotina; Tremellomycetes; Tremellales; Cryptococcaceae; Cryptococcus; Cryptococcus neoformans species complex; Cryptococcus neoformans;
contig_500	NCBI; cellular organisms; Eukaryota; Opisthokonta; Fungi; Dikarya; Basidiomycota; Agaricomycotina; Tremellomycetes; Tremellales; Cryptococcaceae; Cryptococcus; Cryptococcus neoformans species complex; Cryptococcus neoformans;
contig_506	NCBI; cellular organisms; Eukaryota; Opisthokonta; Fungi; Dikarya; Basidiomycota; Agaricomycotina; Tremellomycetes; Tremellales; Cryptococcaceae; Cryptococcus; Cryptococcus neoformans species complex; Cryptococcus neoformans;
contig_52	NCBI; cellular organisms; Eukaryota; Opisthokonta; Fungi; Dikarya; Basidiomycota; Agaricomycotina; Tremellomycetes; Tremellales; Cryptococcaceae; Cryptococcus; Cryptococcus neoformans species complex; Cryptococcus neoformans;
contig_525	NCBI; cellular organisms; Eukaryota; Opisthokonta; Fungi; Dikarya; Basidiomycota; Agaricomycotina; Tremellomycetes; Tremellales; Cryptococcaceae; Cryptococcus; Cryptococcus neoformans species complex; Cryptococcus neoformans;
contig_534	NCBI; cellular organisms; Eukaryota; Opisthokonta; Fungi; Dikarya; Basidiomycota; Agaricomycotina; Tremellomycetes; Tremellales; Cryptococcaceae; Cryptococcus; Cryptococcus neoformans species complex; Cryptococcus neoformans;
contig_544	NCBI; cellular organisms; Eukaryota; Opisthokonta; Fungi; Dikarya; Basidiomycota; Agaricomycotina; Tremellomycetes; Tremellales; Cryptococcaceae; Cryptococcus; Cryptococcus neoformans species complex; Cryptococcus neoformans;
contig_548	NCBI; cellular organisms; Eukaryota; Opisthokonta; Fungi; Dikarya; Basidiomycota; Agaricomycotina; Tremellomycetes; Tremellales; Cryptococcaceae; Cryptococcus; Cryptococcus neoformans species complex; Cryptococcus neoformans;
contig_555	NCBI; cellular organisms; Eukaryota; Opisthokonta; Fungi; Dikarya; Basidiomycota; Agaricomycotina; Tremellomycetes; Tremellales; Cryptococcaceae; Cryptococcus; Cryptococcus neoformans species complex; Cryptococcus neoformans;
contig_557	NCBI; cellular organisms; Eukaryota; Opisthokonta; Fungi; Dikarya; Basidiomycota; Agaricomycotina; Tremellomycetes; Tremellales; Cryptococcaceae; Cryptococcus; Cryptococcus neoformans species complex; Cryptococcus neoformans;
contig_558	NCBI; cellular organisms; Eukaryota; Opisthokonta; Fungi; Dikarya; Basidiomycota; Agaricomycotina; Tremellomycetes; Tremellales; Cryptococcaceae; Cryptococcus; Cryptococcus neoformans species complex; Cryptococcus neoformans;
contig_57	NCBI; cellular organisms; Eukaryota; Opisthokonta; Fungi; Dikarya; Basidiomycota; Agaricomycotina; Tremellomycetes; Tremellales; Cryptococcaceae; Cryptococcus; Cryptococcus neoformans species complex; Cryptococcus neoformans;
contig_582	NCBI; cellular organisms; Eukaryota; Opisthokonta; Fungi; Dikarya; Basidiomycota; Agaricomycotina; Tremellomycetes; Tremellales; Cryptococcaceae; Cryptococcus; Cryptococcus neoformans species complex; Cryptococcus neoformans;
contig_590	NCBI; cellular organisms; Eukaryota; Opisthokonta; Fungi; Dikarya; Basidiomycota; Agaricomycotina; Tremellomycetes; Tremellales; Cryptococcaceae; Cryptococcus; Cryptococcus neoformans species complex; Cryptococcus neoformans;
contig_593	NCBI; cellular organisms; Eukaryota; Opisthokonta; Fungi; Dikarya; Basidiomycota; Agaricomycotina; Tremellomycetes; Tremellales; Cryptococcaceae; Cryptococcus; Cryptococcus neoformans species complex; Cryptococcus neoformans;
contig_594	NCBI; cellular organisms; Eukaryota; Opisthokonta; Fungi; Dikarya; Basidiomycota; Agaricomycotina; Tremellomycetes; Tremellales; Cryptococcaceae; Cryptococcus; Cryptococcus neoformans species complex; Cryptococcus neoformans;
contig_602	NCBI; cellular organisms; Eukaryota; Opisthokonta; Fungi; Dikarya; Basidiomycota; Agaricomycotina; Tremellomycetes; Tremellales; Cryptococcaceae; Cryptococcus; Cryptococcus neoformans species complex; Cryptococcus neoformans;
contig_61	NCBI; cellular organisms; Eukaryota; Opisthokonta; Fungi; Dikarya; Basidiomycota; Agaricomycotina; Tremellomycetes; Tremellales; Cryptococcaceae; Cryptococcus; Cryptococcus neoformans species complex; Cryptococcus neoformans;
contig_616	NCBI; cellular organisms; Eukaryota; Opisthokonta; Fungi; Dikarya; Basidiomycota; Agaricomycotina; Tremellomycetes; Tremellales; Cryptococcaceae; Cryptococcus; Cryptococcus neoformans species complex; Cryptococcus neoformans;
contig_618	NCBI; cellular organisms; Eukaryota; Opisthokonta; Fungi; Dikarya; Basidiomycota; Agaricomycotina; Tremellomycetes; Tremellales; Cryptococcaceae; Cryptococcus; Cryptococcus neoformans species complex; Cryptococcus neoformans;
contig_619	NCBI; cellular organisms; Eukaryota; Opisthokonta; Fungi; Dikarya; Basidiomycota; Agaricomycotina; Tremellomycetes; Tremellales; Cryptococcaceae; Cryptococcus; Cryptococcus neoformans species complex; Cryptococcus neoformans;
contig_622	NCBI; cellular organisms; Eukaryota; Opisthokonta; Fungi; Dikarya; Basidiomycota; Agaricomycotina; Tremellomycetes; Tremellales; Cryptococcaceae; Cryptococcus; Cryptococcus neoformans species complex; Cryptococcus neoformans;
contig_624	NCBI; cellular organisms; Eukaryota; Opisthokonta; Fungi; Dikarya; Basidiomycota; Agaricomycotina; Tremellomycetes; Tremellales; Cryptococcaceae; Cryptococcus; Cryptococcus neoformans species complex; Cryptococcus neoformans;
contig_635	NCBI; cellular organisms; Eukaryota; Opisthokonta; Fungi; Dikarya; Basidiomycota; Agaricomycotina; Tremellomycetes; Tremellales; Cryptococcaceae; Cryptococcus; Cryptococcus neoformans species complex; Cryptococcus neoformans;
contig_637	NCBI; cellular organisms; Eukaryota; Opisthokonta; Fungi; Dikarya; Basidiomycota; Agaricomycotina; Tremellomycetes; Tremellales; Cryptococcaceae; Cryptococcus; Cryptococcus neoformans species complex; Cryptococcus neoformans;
contig_64	NCBI; cellular organisms; Eukaryota; Opisthokonta; Fungi; Dikarya; Basidiomycota; Agaricomycotina; Tremellomycetes; Tremellales; Cryptococcaceae; Cryptococcus; Cryptococcus neoformans species complex; Cryptococcus neoformans;
contig_640	NCBI; cellular organisms; Eukaryota; Opisthokonta; Fungi; Dikarya; Basidiomycota; Agaricomycotina; Tremellomycetes; Tremellales; Cryptococcaceae; Cryptococcus; Cryptococcus neoformans species complex; Cryptococcus neoformans;
contig_642	NCBI; cellular organisms; Eukaryota; Opisthokonta; Fungi; Dikarya; Basidiomycota; Agaricomycotina; Tremellomycetes; Tremellales; Cryptococcaceae; Cryptococcus; Cryptococcus neoformans species complex; Cryptococcus neoformans;
contig_644	NCBI; cellular organisms; Eukaryota; Opisthokonta; Fungi; Dikarya; Basidiomycota; Agaricomycotina; Tremellomycetes; Tremellales; Cryptococcaceae; Cryptococcus; Cryptococcus neoformans species complex; Cryptococcus neoformans;
contig_646	NCBI; cellular organisms; Eukaryota; Opisthokonta; Fungi; Dikarya; Basidiomycota; Agaricomycotina; Tremellomycetes; Tremellales; Cryptococcaceae; Cryptococcus; Cryptococcus neoformans species complex; Cryptococcus neoformans;
contig_658	NCBI; cellular organisms; Eukaryota; Opisthokonta; Fungi; Dikarya; Basidiomycota; Agaricomycotina; Tremellomycetes; Tremellales; Cryptococcaceae; Cryptococcus; Cryptococcus neoformans species complex; Cryptococcus neoformans;
contig_660	NCBI; cellular organisms; Eukaryota; Opisthokonta; Fungi; Dikarya; Basidiomycota; Agaricomycotina; Tremellomycetes; Tremellales; Cryptococcaceae; Cryptococcus; Cryptococcus neoformans species complex; Cryptococcus neoformans;
contig_664	NCBI; cellular organisms; Eukaryota; Opisthokonta; Fungi; Dikarya; Basidiomycota; Agaricomycotina; Tremellomycetes; Tremellales; Cryptococcaceae; Cryptococcus; Cryptococcus neoformans species complex; Cryptococcus neoformans;
contig_666	NCBI; cellular organisms; Eukaryota; Opisthokonta; Fungi; Dikarya; Basidiomycota; Agaricomycotina; Tremellomycetes; Tremellales; Cryptococcaceae; Cryptococcus; Cryptococcus neoformans species complex; Cryptococcus neoformans;
contig_669	NCBI; cellular organisms; Eukaryota; Opisthokonta; Fungi; Dikarya; Basidiomycota; Agaricomycotina; Tremellomycetes; Tremellales; Cryptococcaceae; Cryptococcus; Cryptococcus neoformans species complex; Cryptococcus neoformans;
contig_673	NCBI; cellular organisms; Eukaryota; Opisthokonta; Fungi; Dikarya; Basidiomycota; Agaricomycotina; Tremellomycetes; Tremellales; Cryptococcaceae; Cryptococcus; Cryptococcus neoformans species complex; Cryptococcus neoformans;
contig_675	NCBI; cellular organisms; Eukaryota; Opisthokonta; Fungi; Dikarya; Basidiomycota; Agaricomycotina; Tremellomycetes; Tremellales; Cryptococcaceae; Cryptococcus; Cryptococcus neoformans species complex; Cryptococcus neoformans;
contig_679	NCBI; cellular organisms; Eukaryota; Opisthokonta; Fungi; Dikarya; Basidiomycota; Agaricomycotina; Tremellomycetes; Tremellales; Cryptococcaceae; Cryptococcus; Cryptococcus neoformans species complex; Cryptococcus neoformans;
contig_680	NCBI; cellular organisms; Eukaryota; Opisthokonta; Fungi; Dikarya; Basidiomycota; Agaricomycotina; Tremellomycetes; Tremellales; Cryptococcaceae; Cryptococcus; Cryptococcus neoformans species complex; Cryptococcus neoformans;
contig_682	NCBI; cellular organisms; Eukaryota; Opisthokonta; Fungi; Dikarya; Basidiomycota; Agaricomycotina; Tremellomycetes; Tremellales; Cryptococcaceae; Cryptococcus; Cryptococcus neoformans species complex; Cryptococcus neoformans;
contig_683	NCBI; cellular organisms; Eukaryota; Opisthokonta; Fungi; Dikarya; Basidiomycota; Agaricomycotina; Tremellomycetes; Tremellales; Cryptococcaceae; Cryptococcus; Cryptococcus neoformans species complex; Cryptococcus neoformans;
contig_686	NCBI; cellular organisms; Eukaryota; Opisthokonta; Fungi; Dikarya; Basidiomycota; Agaricomycotina; Tremellomycetes; Tremellales; Cryptococcaceae; Cryptococcus; Cryptococcus neoformans species complex; Cryptococcus neoformans;
contig_687	NCBI; cellular organisms; Eukaryota; Opisthokonta; Fungi; Dikarya; Basidiomycota; Agaricomycotina; Tremellomycetes; Tremellales; Cryptococcaceae; Cryptococcus; Cryptococcus neoformans species complex; Cryptococcus neoformans;
contig_69	NCBI; cellular organisms; Eukaryota; Opisthokonta; Fungi; Dikarya; Basidiomycota; Agaricomycotina; Tremellomycetes; Tremellales; Cryptococcaceae; Cryptococcus; Cryptococcus neoformans species complex; Cryptococcus neoformans;
contig_70	NCBI; cellular organisms; Eukaryota; Opisthokonta; Fungi; Dikarya; Basidiomycota; Agaricomycotina; Tremellomycetes; Tremellales; Cryptococcaceae; Cryptococcus; Cryptococcus neoformans species complex; Cryptococcus neoformans;
contig_73	NCBI; cellular organisms; Eukaryota; Opisthokonta; Fungi; Dikarya; Basidiomycota; Agaricomycotina; Tremellomycetes; Tremellales; Cryptococcaceae; Cryptococcus; Cryptococcus neoformans species complex; Cryptococcus neoformans;
contig_83	NCBI; cellular organisms; Eukaryota; Opisthokonta; Fungi; Dikarya; Basidiomycota; Agaricomycotina; Tremellomycetes; Tremellales; Cryptococcaceae; Cryptococcus; Cryptococcus neoformans species complex; Cryptococcus neoformans;
contig_86	NCBI; cellular organisms; Eukaryota; Opisthokonta; Fungi; Dikarya; Basidiomycota; Agaricomycotina; Tremellomycetes; Tremellales; Cryptococcaceae; Cryptococcus; Cryptococcus neoformans species complex; Cryptococcus neoformans;
contig_87	NCBI; cellular organisms; Eukaryota; Opisthokonta; Fungi; Dikarya; Basidiomycota; Agaricomycotina; Tremellomycetes; Tremellales; Cryptococcaceae; Cryptococcus; Cryptococcus neoformans species complex; Cryptococcus neoformans;
contig_91	NCBI; cellular organisms; Eukaryota; Opisthokonta; Fungi; Dikarya; Basidiomycota; Agaricomycotina; Tremellomycetes; Tremellales; Cryptococcaceae; Cryptococcus; Cryptococcus neoformans species complex; Cryptococcus neoformans;
contig_92	NCBI; cellular organisms; Eukaryota; Opisthokonta; Fungi; Dikarya; Basidiomycota; Agaricomycotina; Tremellomycetes; Tremellales; Cryptococcaceae; Cryptococcus; Cryptococcus neoformans species complex; Cryptococcus neoformans;
contig_308	NCBI; cellular organisms; Bacteria; Proteobacteria; Gammaproteobacteria; Enterobacterales; Enterobacteriaceae; Salmonella; Salmonella enterica;
contig_384	NCBI; cellular organisms; Eukaryota; Opisthokonta; Fungi; Dikarya; Basidiomycota; Agaricomycotina; Tremellomycetes; Tremellales; Cryptococcaceae; Cryptococcus; Cryptococcus neoformans species complex; Cryptococcus neoformans; Cryptococcus neoformans var. neoformans;
contig_392	NCBI; cellular organisms; Eukaryota; Opisthokonta; Fungi; Dikarya; Basidiomycota; Agaricomycotina; Tremellomycetes; Tremellales; Cryptococcaceae; Cryptococcus; Cryptococcus neoformans species complex; Cryptococcus neoformans; Cryptococcus neoformans var. neoformans;
contig_449	NCBI; cellular organisms; Eukaryota; Opisthokonta; Fungi; Dikarya; Basidiomycota; Agaricomycotina; Tremellomycetes; Tremellales; Cryptococcaceae; Cryptococcus; Cryptococcus neoformans species complex; Cryptococcus neoformans; Cryptococcus neoformans var. neoformans;
contig_486	NCBI; cellular organisms; Eukaryota; Opisthokonta; Fungi; Dikarya; Basidiomycota; Agaricomycotina; Tremellomycetes; Tremellales; Cryptococcaceae; Cryptococcus; Cryptococcus neoformans species complex; Cryptococcus neoformans; Cryptococcus neoformans var. neoformans;
contig_589	NCBI; cellular organisms; Eukaryota; Opisthokonta; Fungi; Dikarya; Basidiomycota; Agaricomycotina; Tremellomycetes; Tremellales; Cryptococcaceae; Cryptococcus; Cryptococcus neoformans species complex; Cryptococcus neoformans; Cryptococcus neoformans var. neoformans;
contig_607	NCBI; cellular organisms; Bacteria; Proteobacteria; Gammaproteobacteria; Enterobacterales; Enterobacteriaceae; Salmonella; Salmonella enterica; Salmonella enterica subsp. enterica;
contig_688	NCBI; cellular organisms; Bacteria; Proteobacteria; Gammaproteobacteria; Enterobacterales; Enterobacteriaceae; Salmonella; Salmonella enterica; Salmonella enterica subsp. enterica;
contig_141	NCBI; cellular organisms; Eukaryota; Opisthokonta; Fungi; Dikarya; Basidiomycota; Agaricomycotina; Tremellomycetes; Tremellales; Cryptococcaceae; Cryptococcus; Cryptococcus neoformans species complex; Cryptococcus neoformans; Cryptococcus neoformans var. grubii;
contig_143	NCBI; cellular organisms; Eukaryota; Opisthokonta; Fungi; Dikarya; Basidiomycota; Agaricomycotina; Tremellomycetes; Tremellales; Cryptococcaceae; Cryptococcus; Cryptococcus neoformans species complex; Cryptococcus neoformans; Cryptococcus neoformans var. grubii;
contig_148	NCBI; cellular organisms; Eukaryota; Opisthokonta; Fungi; Dikarya; Basidiomycota; Agaricomycotina; Tremellomycetes; Tremellales; Cryptococcaceae; Cryptococcus; Cryptococcus neoformans species complex; Cryptococcus neoformans; Cryptococcus neoformans var. grubii;
contig_175	NCBI; cellular organisms; Eukaryota; Opisthokonta; Fungi; Dikarya; Basidiomycota; Agaricomycotina; Tremellomycetes; Tremellales; Cryptococcaceae; Cryptococcus; Cryptococcus neoformans species complex; Cryptococcus neoformans; Cryptococcus neoformans var. grubii;
contig_191	NCBI; cellular organisms; Eukaryota; Opisthokonta; Fungi; Dikarya; Basidiomycota; Agaricomycotina; Tremellomycetes; Tremellales; Cryptococcaceae; Cryptococcus; Cryptococcus neoformans species complex; Cryptococcus neoformans; Cryptococcus neoformans var. grubii;
contig_254	NCBI; cellular organisms; Eukaryota; Opisthokonta; Fungi; Dikarya; Basidiomycota; Agaricomycotina; Tremellomycetes; Tremellales; Cryptococcaceae; Cryptococcus; Cryptococcus neoformans species complex; Cryptococcus neoformans; Cryptococcus neoformans var. grubii;
contig_258	NCBI; cellular organisms; Eukaryota; Opisthokonta; Fungi; Dikarya; Basidiomycota; Agaricomycotina; Tremellomycetes; Tremellales; Cryptococcaceae; Cryptococcus; Cryptococcus neoformans species complex; Cryptococcus neoformans; Cryptococcus neoformans var. grubii;
contig_287	NCBI; cellular organisms; Eukaryota; Opisthokonta; Fungi; Dikarya; Basidiomycota; Agaricomycotina; Tremellomycetes; Tremellales; Cryptococcaceae; Cryptococcus; Cryptococcus neoformans species complex; Cryptococcus neoformans; Cryptococcus neoformans var. grubii;
contig_299	NCBI; cellular organisms; Eukaryota; Opisthokonta; Fungi; Dikarya; Basidiomycota; Agaricomycotina; Tremellomycetes; Tremellales; Cryptococcaceae; Cryptococcus; Cryptococcus neoformans species complex; Cryptococcus neoformans; Cryptococcus neoformans var. grubii;
contig_317	NCBI; cellular organisms; Eukaryota; Opisthokonta; Fungi; Dikarya; Basidiomycota; Agaricomycotina; Tremellomycetes; Tremellales; Cryptococcaceae; Cryptococcus; Cryptococcus neoformans species complex; Cryptococcus neoformans; Cryptococcus neoformans var. grubii;
contig_333	NCBI; cellular organisms; Eukaryota; Opisthokonta; Fungi; Dikarya; Basidiomycota; Agaricomycotina; Tremellomycetes; Tremellales; Cryptococcaceae; Cryptococcus; Cryptococcus neoformans species complex; Cryptococcus neoformans; Cryptococcus neoformans var. grubii;
contig_337	NCBI; cellular organisms; Eukaryota; Opisthokonta; Fungi; Dikarya; Basidiomycota; Agaricomycotina; Tremellomycetes; Tremellales; Cryptococcaceae; Cryptococcus; Cryptococcus neoformans species complex; Cryptococcus neoformans; Cryptococcus neoformans var. grubii;
contig_385	NCBI; cellular organisms; Eukaryota; Opisthokonta; Fungi; Dikarya; Basidiomycota; Agaricomycotina; Tremellomycetes; Tremellales; Cryptococcaceae; Cryptococcus; Cryptococcus neoformans species complex; Cryptococcus neoformans; Cryptococcus neoformans var. grubii;
contig_398	NCBI; cellular organisms; Eukaryota; Opisthokonta; Fungi; Dikarya; Basidiomycota; Agaricomycotina; Tremellomycetes; Tremellales; Cryptococcaceae; Cryptococcus; Cryptococcus neoformans species complex; Cryptococcus neoformans; Cryptococcus neoformans var. grubii;
contig_406	NCBI; cellular organisms; Eukaryota; Opisthokonta; Fungi; Dikarya; Basidiomycota; Agaricomycotina; Tremellomycetes; Tremellales; Cryptococcaceae; Cryptococcus; Cryptococcus neoformans species complex; Cryptococcus neoformans; Cryptococcus neoformans var. grubii;
contig_408	NCBI; cellular organisms; Eukaryota; Opisthokonta; Fungi; Dikarya; Basidiomycota; Agaricomycotina; Tremellomycetes; Tremellales; Cryptococcaceae; Cryptococcus; Cryptococcus neoformans species complex; Cryptococcus neoformans; Cryptococcus neoformans var. grubii;
contig_416	NCBI; cellular organisms; Eukaryota; Opisthokonta; Fungi; Dikarya; Basidiomycota; Agaricomycotina; Tremellomycetes; Tremellales; Cryptococcaceae; Cryptococcus; Cryptococcus neoformans species complex; Cryptococcus neoformans; Cryptococcus neoformans var. grubii;
contig_425	NCBI; cellular organisms; Eukaryota; Opisthokonta; Fungi; Dikarya; Basidiomycota; Agaricomycotina; Tremellomycetes; Tremellales; Cryptococcaceae; Cryptococcus; Cryptococcus neoformans species complex; Cryptococcus neoformans; Cryptococcus neoformans var. grubii;
contig_469	NCBI; cellular organisms; Eukaryota; Opisthokonta; Fungi; Dikarya; Basidiomycota; Agaricomycotina; Tremellomycetes; Tremellales; Cryptococcaceae; Cryptococcus; Cryptococcus neoformans species complex; Cryptococcus neoformans; Cryptococcus neoformans var. grubii;
contig_48	NCBI; cellular organisms; Eukaryota; Opisthokonta; Fungi; Dikarya; Basidiomycota; Agaricomycotina; Tremellomycetes; Tremellales; Cryptococcaceae; Cryptococcus; Cryptococcus neoformans species complex; Cryptococcus neoformans; Cryptococcus neoformans var. grubii;
contig_507	NCBI; cellular organisms; Eukaryota; Opisthokonta; Fungi; Dikarya; Basidiomycota; Agaricomycotina; Tremellomycetes; Tremellales; Cryptococcaceae; Cryptococcus; Cryptococcus neoformans species complex; Cryptococcus neoformans; Cryptococcus neoformans var. grubii;
contig_540	NCBI; cellular organisms; Eukaryota; Opisthokonta; Fungi; Dikarya; Basidiomycota; Agaricomycotina; Tremellomycetes; Tremellales; Cryptococcaceae; Cryptococcus; Cryptococcus neoformans species complex; Cryptococcus neoformans; Cryptococcus neoformans var. grubii;
contig_547	NCBI; cellular organisms; Eukaryota; Opisthokonta; Fungi; Dikarya; Basidiomycota; Agaricomycotina; Tremellomycetes; Tremellales; Cryptococcaceae; Cryptococcus; Cryptococcus neoformans species complex; Cryptococcus neoformans; Cryptococcus neoformans var. grubii;
contig_569	NCBI; cellular organisms; Eukaryota; Opisthokonta; Fungi; Dikarya; Basidiomycota; Agaricomycotina; Tremellomycetes; Tremellales; Cryptococcaceae; Cryptococcus; Cryptococcus neoformans species complex; Cryptococcus neoformans; Cryptococcus neoformans var. grubii;
contig_58	NCBI; cellular organisms; Eukaryota; Opisthokonta; Fungi; Dikarya; Basidiomycota; Agaricomycotina; Tremellomycetes; Tremellales; Cryptococcaceae; Cryptococcus; Cryptococcus neoformans species complex; Cryptococcus neoformans; Cryptococcus neoformans var. grubii;
contig_592	NCBI; cellular organisms; Eukaryota; Opisthokonta; Fungi; Dikarya; Basidiomycota; Agaricomycotina; Tremellomycetes; Tremellales; Cryptococcaceae; Cryptococcus; Cryptococcus neoformans species complex; Cryptococcus neoformans; Cryptococcus neoformans var. grubii;
contig_599	NCBI; cellular organisms; Eukaryota; Opisthokonta; Fungi; Dikarya; Basidiomycota; Agaricomycotina; Tremellomycetes; Tremellales; Cryptococcaceae; Cryptococcus; Cryptococcus neoformans species complex; Cryptococcus neoformans; Cryptococcus neoformans var. grubii;
contig_611	NCBI; cellular organisms; Eukaryota; Opisthokonta; Fungi; Dikarya; Basidiomycota; Agaricomycotina; Tremellomycetes; Tremellales; Cryptococcaceae; Cryptococcus; Cryptococcus neoformans species complex; Cryptococcus neoformans; Cryptococcus neoformans var. grubii;
contig_621	NCBI; cellular organisms; Eukaryota; Opisthokonta; Fungi; Dikarya; Basidiomycota; Agaricomycotina; Tremellomycetes; Tremellales; Cryptococcaceae; Cryptococcus; Cryptococcus neoformans species complex; Cryptococcus neoformans; Cryptococcus neoformans var. grubii;
contig_634	NCBI; cellular organisms; Eukaryota; Opisthokonta; Fungi; Dikarya; Basidiomycota; Agaricomycotina; Tremellomycetes; Tremellales; Cryptococcaceae; Cryptococcus; Cryptococcus neoformans species complex; Cryptococcus neoformans; Cryptococcus neoformans var. grubii;
contig_118	NCBI; cellular organisms; Eukaryota; Opisthokonta; Fungi; Dikarya; Basidiomycota; Agaricomycotina; Tremellomycetes; Tremellales; Cryptococcaceae; Cryptococcus; Cryptococcus neoformans species complex; Cryptococcus neoformans; Cryptococcus neoformans var. neoformans; Cryptococcus neoformans var. neoformans JEC21;
contig_119	NCBI; cellular organisms; Eukaryota; Opisthokonta; Fungi; Dikarya; Basidiomycota; Agaricomycotina; Tremellomycetes; Tremellales; Cryptococcaceae; Cryptococcus; Cryptococcus neoformans species complex; Cryptococcus neoformans; Cryptococcus neoformans var. neoformans; Cryptococcus neoformans var. neoformans JEC21;
contig_122	NCBI; cellular organisms; Eukaryota; Opisthokonta; Fungi; Dikarya; Basidiomycota; Agaricomycotina; Tremellomycetes; Tremellales; Cryptococcaceae; Cryptococcus; Cryptococcus neoformans species complex; Cryptococcus neoformans; Cryptococcus neoformans var. neoformans; Cryptococcus neoformans var. neoformans JEC21;
contig_123	NCBI; cellular organisms; Eukaryota; Opisthokonta; Fungi; Dikarya; Basidiomycota; Agaricomycotina; Tremellomycetes; Tremellales; Cryptococcaceae; Cryptococcus; Cryptococcus neoformans species complex; Cryptococcus neoformans; Cryptococcus neoformans var. neoformans; Cryptococcus neoformans var. neoformans JEC21;
contig_127	NCBI; cellular organisms; Eukaryota; Opisthokonta; Fungi; Dikarya; Basidiomycota; Agaricomycotina; Tremellomycetes; Tremellales; Cryptococcaceae; Cryptococcus; Cryptococcus neoformans species complex; Cryptococcus neoformans; Cryptococcus neoformans var. neoformans; Cryptococcus neoformans var. neoformans JEC21;
contig_129	NCBI; cellular organisms; Eukaryota; Opisthokonta; Fungi; Dikarya; Basidiomycota; Agaricomycotina; Tremellomycetes; Tremellales; Cryptococcaceae; Cryptococcus; Cryptococcus neoformans species complex; Cryptococcus neoformans; Cryptococcus neoformans var. neoformans; Cryptococcus neoformans var. neoformans JEC21;
contig_130	NCBI; cellular organisms; Eukaryota; Opisthokonta; Fungi; Dikarya; Basidiomycota; Agaricomycotina; Tremellomycetes; Tremellales; Cryptococcaceae; Cryptococcus; Cryptococcus neoformans species complex; Cryptococcus neoformans; Cryptococcus neoformans var. neoformans; Cryptococcus neoformans var. neoformans JEC21;
contig_131	NCBI; cellular organisms; Eukaryota; Opisthokonta; Fungi; Dikarya; Basidiomycota; Agaricomycotina; Tremellomycetes; Tremellales; Cryptococcaceae; Cryptococcus; Cryptococcus neoformans species complex; Cryptococcus neoformans; Cryptococcus neoformans var. neoformans; Cryptococcus neoformans var. neoformans JEC21;
contig_137	NCBI; cellular organisms; Eukaryota; Opisthokonta; Fungi; Dikarya; Basidiomycota; Agaricomycotina; Tremellomycetes; Tremellales; Cryptococcaceae; Cryptococcus; Cryptococcus neoformans species complex; Cryptococcus neoformans; Cryptococcus neoformans var. neoformans; Cryptococcus neoformans var. neoformans JEC21;
contig_140	NCBI; cellular organisms; Eukaryota; Opisthokonta; Fungi; Dikarya; Basidiomycota; Agaricomycotina; Tremellomycetes; Tremellales; Cryptococcaceae; Cryptococcus; Cryptococcus neoformans species complex; Cryptococcus neoformans; Cryptococcus neoformans var. neoformans; Cryptococcus neoformans var. neoformans JEC21;
contig_142	NCBI; cellular organisms; Eukaryota; Opisthokonta; Fungi; Dikarya; Basidiomycota; Agaricomycotina; Tremellomycetes; Tremellales; Cryptococcaceae; Cryptococcus; Cryptococcus neoformans species complex; Cryptococcus neoformans; Cryptococcus neoformans var. neoformans; Cryptococcus neoformans var. neoformans JEC21;
contig_145	NCBI; cellular organisms; Eukaryota; Opisthokonta; Fungi; Dikarya; Basidiomycota; Agaricomycotina; Tremellomycetes; Tremellales; Cryptococcaceae; Cryptococcus; Cryptococcus neoformans species complex; Cryptococcus neoformans; Cryptococcus neoformans var. neoformans; Cryptococcus neoformans var. neoformans JEC21;
contig_147	NCBI; cellular organisms; Eukaryota; Opisthokonta; Fungi; Dikarya; Basidiomycota; Agaricomycotina; Tremellomycetes; Tremellales; Cryptococcaceae; Cryptococcus; Cryptococcus neoformans species complex; Cryptococcus neoformans; Cryptococcus neoformans var. neoformans; Cryptococcus neoformans var. neoformans JEC21;
contig_173	NCBI; cellular organisms; Eukaryota; Opisthokonta; Fungi; Dikarya; Basidiomycota; Agaricomycotina; Tremellomycetes; Tremellales; Cryptococcaceae; Cryptococcus; Cryptococcus neoformans species complex; Cryptococcus neoformans; Cryptococcus neoformans var. neoformans; Cryptococcus neoformans var. neoformans JEC21;
contig_177	NCBI; cellular organisms; Eukaryota; Opisthokonta; Fungi; Dikarya; Basidiomycota; Agaricomycotina; Tremellomycetes; Tremellales; Cryptococcaceae; Cryptococcus; Cryptococcus neoformans species complex; Cryptococcus neoformans; Cryptococcus neoformans var. neoformans; Cryptococcus neoformans var. neoformans JEC21;
contig_185	NCBI; cellular organisms; Eukaryota; Opisthokonta; Fungi; Dikarya; Basidiomycota; Agaricomycotina; Tremellomycetes; Tremellales; Cryptococcaceae; Cryptococcus; Cryptococcus neoformans species complex; Cryptococcus neoformans; Cryptococcus neoformans var. neoformans; Cryptococcus neoformans var. neoformans JEC21;
contig_192	NCBI; cellular organisms; Eukaryota; Opisthokonta; Fungi; Dikarya; Basidiomycota; Agaricomycotina; Tremellomycetes; Tremellales; Cryptococcaceae; Cryptococcus; Cryptococcus neoformans species complex; Cryptococcus neoformans; Cryptococcus neoformans var. neoformans; Cryptococcus neoformans var. neoformans JEC21;
contig_198	NCBI; cellular organisms; Eukaryota; Opisthokonta; Fungi; Dikarya; Basidiomycota; Agaricomycotina; Tremellomycetes; Tremellales; Cryptococcaceae; Cryptococcus; Cryptococcus neoformans species complex; Cryptococcus neoformans; Cryptococcus neoformans var. neoformans; Cryptococcus neoformans var. neoformans JEC21;
contig_203	NCBI; cellular organisms; Eukaryota; Opisthokonta; Fungi; Dikarya; Basidiomycota; Agaricomycotina; Tremellomycetes; Tremellales; Cryptococcaceae; Cryptococcus; Cryptococcus neoformans species complex; Cryptococcus neoformans; Cryptococcus neoformans var. neoformans; Cryptococcus neoformans var. neoformans JEC21;
contig_204	NCBI; cellular organisms; Eukaryota; Opisthokonta; Fungi; Dikarya; Basidiomycota; Agaricomycotina; Tremellomycetes; Tremellales; Cryptococcaceae; Cryptococcus; Cryptococcus neoformans species complex; Cryptococcus neoformans; Cryptococcus neoformans var. neoformans; Cryptococcus neoformans var. neoformans JEC21;
contig_210	NCBI; cellular organisms; Eukaryota; Opisthokonta; Fungi; Dikarya; Basidiomycota; Agaricomycotina; Tremellomycetes; Tremellales; Cryptococcaceae; Cryptococcus; Cryptococcus neoformans species complex; Cryptococcus neoformans; Cryptococcus neoformans var. neoformans; Cryptococcus neoformans var. neoformans JEC21;
contig_213	NCBI; cellular organisms; Eukaryota; Opisthokonta; Fungi; Dikarya; Basidiomycota; Agaricomycotina; Tremellomycetes; Tremellales; Cryptococcaceae; Cryptococcus; Cryptococcus neoformans species complex; Cryptococcus neoformans; Cryptococcus neoformans var. neoformans; Cryptococcus neoformans var. neoformans JEC21;
contig_215	NCBI; cellular organisms; Eukaryota; Opisthokonta; Fungi; Dikarya; Basidiomycota; Agaricomycotina; Tremellomycetes; Tremellales; Cryptococcaceae; Cryptococcus; Cryptococcus neoformans species complex; Cryptococcus neoformans; Cryptococcus neoformans var. neoformans; Cryptococcus neoformans var. neoformans JEC21;
contig_236	NCBI; cellular organisms; Eukaryota; Opisthokonta; Fungi; Dikarya; Basidiomycota; Agaricomycotina; Tremellomycetes; Tremellales; Cryptococcaceae; Cryptococcus; Cryptococcus neoformans species complex; Cryptococcus neoformans; Cryptococcus neoformans var. neoformans; Cryptococcus neoformans var. neoformans JEC21;
contig_239	NCBI; cellular organisms; Eukaryota; Opisthokonta; Fungi; Dikarya; Basidiomycota; Agaricomycotina; Tremellomycetes; Tremellales; Cryptococcaceae; Cryptococcus; Cryptococcus neoformans species complex; Cryptococcus neoformans; Cryptococcus neoformans var. neoformans; Cryptococcus neoformans var. neoformans JEC21;
contig_244	NCBI; cellular organisms; Eukaryota; Opisthokonta; Fungi; Dikarya; Basidiomycota; Agaricomycotina; Tremellomycetes; Tremellales; Cryptococcaceae; Cryptococcus; Cryptococcus neoformans species complex; Cryptococcus neoformans; Cryptococcus neoformans var. neoformans; Cryptococcus neoformans var. neoformans JEC21;
contig_247	NCBI; cellular organisms; Eukaryota; Opisthokonta; Fungi; Dikarya; Basidiomycota; Agaricomycotina; Tremellomycetes; Tremellales; Cryptococcaceae; Cryptococcus; Cryptococcus neoformans species complex; Cryptococcus neoformans; Cryptococcus neoformans var. neoformans; Cryptococcus neoformans var. neoformans JEC21;
contig_248	NCBI; cellular organisms; Eukaryota; Opisthokonta; Fungi; Dikarya; Basidiomycota; Agaricomycotina; Tremellomycetes; Tremellales; Cryptococcaceae; Cryptococcus; Cryptococcus neoformans species complex; Cryptococcus neoformans; Cryptococcus neoformans var. neoformans; Cryptococcus neoformans var. neoformans JEC21;
contig_249	NCBI; cellular organisms; Eukaryota; Opisthokonta; Fungi; Dikarya; Basidiomycota; Agaricomycotina; Tremellomycetes; Tremellales; Cryptococcaceae; Cryptococcus; Cryptococcus neoformans species complex; Cryptococcus neoformans; Cryptococcus neoformans var. neoformans; Cryptococcus neoformans var. neoformans JEC21;
contig_251	NCBI; cellular organisms; Eukaryota; Opisthokonta; Fungi; Dikarya; Basidiomycota; Agaricomycotina; Tremellomycetes; Tremellales; Cryptococcaceae; Cryptococcus; Cryptococcus neoformans species complex; Cryptococcus neoformans; Cryptococcus neoformans var. neoformans; Cryptococcus neoformans var. neoformans JEC21;
contig_252	NCBI; cellular organisms; Eukaryota; Opisthokonta; Fungi; Dikarya; Basidiomycota; Agaricomycotina; Tremellomycetes; Tremellales; Cryptococcaceae; Cryptococcus; Cryptococcus neoformans species complex; Cryptococcus neoformans; Cryptococcus neoformans var. neoformans; Cryptococcus neoformans var. neoformans JEC21;
contig_253	NCBI; cellular organisms; Eukaryota; Opisthokonta; Fungi; Dikarya; Basidiomycota; Agaricomycotina; Tremellomycetes; Tremellales; Cryptococcaceae; Cryptococcus; Cryptococcus neoformans species complex; Cryptococcus neoformans; Cryptococcus neoformans var. neoformans; Cryptococcus neoformans var. neoformans JEC21;
contig_255	NCBI; cellular organisms; Eukaryota; Opisthokonta; Fungi; Dikarya; Basidiomycota; Agaricomycotina; Tremellomycetes; Tremellales; Cryptococcaceae; Cryptococcus; Cryptococcus neoformans species complex; Cryptococcus neoformans; Cryptococcus neoformans var. neoformans; Cryptococcus neoformans var. neoformans JEC21;
contig_257	NCBI; cellular organisms; Eukaryota; Opisthokonta; Fungi; Dikarya; Basidiomycota; Agaricomycotina; Tremellomycetes; Tremellales; Cryptococcaceae; Cryptococcus; Cryptococcus neoformans species complex; Cryptococcus neoformans; Cryptococcus neoformans var. neoformans; Cryptococcus neoformans var. neoformans JEC21;
contig_260	NCBI; cellular organisms; Eukaryota; Opisthokonta; Fungi; Dikarya; Basidiomycota; Agaricomycotina; Tremellomycetes; Tremellales; Cryptococcaceae; Cryptococcus; Cryptococcus neoformans species complex; Cryptococcus neoformans; Cryptococcus neoformans var. neoformans; Cryptococcus neoformans var. neoformans JEC21;
contig_268	NCBI; cellular organisms; Eukaryota; Opisthokonta; Fungi; Dikarya; Basidiomycota; Agaricomycotina; Tremellomycetes; Tremellales; Cryptococcaceae; Cryptococcus; Cryptococcus neoformans species complex; Cryptococcus neoformans; Cryptococcus neoformans var. neoformans; Cryptococcus neoformans var. neoformans JEC21;
contig_271	NCBI; cellular organisms; Eukaryota; Opisthokonta; Fungi; Dikarya; Basidiomycota; Agaricomycotina; Tremellomycetes; Tremellales; Cryptococcaceae; Cryptococcus; Cryptococcus neoformans species complex; Cryptococcus neoformans; Cryptococcus neoformans var. neoformans; Cryptococcus neoformans var. neoformans JEC21;
contig_274	NCBI; cellular organisms; Eukaryota; Opisthokonta; Fungi; Dikarya; Basidiomycota; Agaricomycotina; Tremellomycetes; Tremellales; Cryptococcaceae; Cryptococcus; Cryptococcus neoformans species complex; Cryptococcus neoformans; Cryptococcus neoformans var. neoformans; Cryptococcus neoformans var. neoformans JEC21;
contig_275	NCBI; cellular organisms; Eukaryota; Opisthokonta; Fungi; Dikarya; Basidiomycota; Agaricomycotina; Tremellomycetes; Tremellales; Cryptococcaceae; Cryptococcus; Cryptococcus neoformans species complex; Cryptococcus neoformans; Cryptococcus neoformans var. neoformans; Cryptococcus neoformans var. neoformans JEC21;
contig_277	NCBI; cellular organisms; Eukaryota; Opisthokonta; Fungi; Dikarya; Basidiomycota; Agaricomycotina; Tremellomycetes; Tremellales; Cryptococcaceae; Cryptococcus; Cryptococcus neoformans species complex; Cryptococcus neoformans; Cryptococcus neoformans var. neoformans; Cryptococcus neoformans var. neoformans JEC21;
contig_278	NCBI; cellular organisms; Eukaryota; Opisthokonta; Fungi; Dikarya; Basidiomycota; Agaricomycotina; Tremellomycetes; Tremellales; Cryptococcaceae; Cryptococcus; Cryptococcus neoformans species complex; Cryptococcus neoformans; Cryptococcus neoformans var. neoformans; Cryptococcus neoformans var. neoformans JEC21;
contig_282	NCBI; cellular organisms; Eukaryota; Opisthokonta; Fungi; Dikarya; Basidiomycota; Agaricomycotina; Tremellomycetes; Tremellales; Cryptococcaceae; Cryptococcus; Cryptococcus neoformans species complex; Cryptococcus neoformans; Cryptococcus neoformans var. neoformans; Cryptococcus neoformans var. neoformans JEC21;
contig_283	NCBI; cellular organisms; Eukaryota; Opisthokonta; Fungi; Dikarya; Basidiomycota; Agaricomycotina; Tremellomycetes; Tremellales; Cryptococcaceae; Cryptococcus; Cryptococcus neoformans species complex; Cryptococcus neoformans; Cryptococcus neoformans var. neoformans; Cryptococcus neoformans var. neoformans JEC21;
contig_285	NCBI; cellular organisms; Eukaryota; Opisthokonta; Fungi; Dikarya; Basidiomycota; Agaricomycotina; Tremellomycetes; Tremellales; Cryptococcaceae; Cryptococcus; Cryptococcus neoformans species complex; Cryptococcus neoformans; Cryptococcus neoformans var. neoformans; Cryptococcus neoformans var. neoformans JEC21;
contig_286	NCBI; cellular organisms; Eukaryota; Opisthokonta; Fungi; Dikarya; Basidiomycota; Agaricomycotina; Tremellomycetes; Tremellales; Cryptococcaceae; Cryptococcus; Cryptococcus neoformans species complex; Cryptococcus neoformans; Cryptococcus neoformans var. neoformans; Cryptococcus neoformans var. neoformans JEC21;
contig_288	NCBI; cellular organisms; Eukaryota; Opisthokonta; Fungi; Dikarya; Basidiomycota; Agaricomycotina; Tremellomycetes; Tremellales; Cryptococcaceae; Cryptococcus; Cryptococcus neoformans species complex; Cryptococcus neoformans; Cryptococcus neoformans var. neoformans; Cryptococcus neoformans var. neoformans JEC21;
contig_289	NCBI; cellular organisms; Eukaryota; Opisthokonta; Fungi; Dikarya; Basidiomycota; Agaricomycotina; Tremellomycetes; Tremellales; Cryptococcaceae; Cryptococcus; Cryptococcus neoformans species complex; Cryptococcus neoformans; Cryptococcus neoformans var. neoformans; Cryptococcus neoformans var. neoformans JEC21;
contig_290	NCBI; cellular organisms; Eukaryota; Opisthokonta; Fungi; Dikarya; Basidiomycota; Agaricomycotina; Tremellomycetes; Tremellales; Cryptococcaceae; Cryptococcus; Cryptococcus neoformans species complex; Cryptococcus neoformans; Cryptococcus neoformans var. neoformans; Cryptococcus neoformans var. neoformans JEC21;
contig_292	NCBI; cellular organisms; Eukaryota; Opisthokonta; Fungi; Dikarya; Basidiomycota; Agaricomycotina; Tremellomycetes; Tremellales; Cryptococcaceae; Cryptococcus; Cryptococcus neoformans species complex; Cryptococcus neoformans; Cryptococcus neoformans var. neoformans; Cryptococcus neoformans var. neoformans JEC21;
contig_294	NCBI; cellular organisms; Eukaryota; Opisthokonta; Fungi; Dikarya; Basidiomycota; Agaricomycotina; Tremellomycetes; Tremellales; Cryptococcaceae; Cryptococcus; Cryptococcus neoformans species complex; Cryptococcus neoformans; Cryptococcus neoformans var. neoformans; Cryptococcus neoformans var. neoformans JEC21;
contig_298	NCBI; cellular organisms; Eukaryota; Opisthokonta; Fungi; Dikarya; Basidiomycota; Agaricomycotina; Tremellomycetes; Tremellales; Cryptococcaceae; Cryptococcus; Cryptococcus neoformans species complex; Cryptococcus neoformans; Cryptococcus neoformans var. neoformans; Cryptococcus neoformans var. neoformans JEC21;
contig_303	NCBI; cellular organisms; Eukaryota; Opisthokonta; Fungi; Dikarya; Basidiomycota; Agaricomycotina; Tremellomycetes; Tremellales; Cryptococcaceae; Cryptococcus; Cryptococcus neoformans species complex; Cryptococcus neoformans; Cryptococcus neoformans var. neoformans; Cryptococcus neoformans var. neoformans JEC21;
contig_306	NCBI; cellular organisms; Eukaryota; Opisthokonta; Fungi; Dikarya; Basidiomycota; Agaricomycotina; Tremellomycetes; Tremellales; Cryptococcaceae; Cryptococcus; Cryptococcus neoformans species complex; Cryptococcus neoformans; Cryptococcus neoformans var. neoformans; Cryptococcus neoformans var. neoformans JEC21;
contig_307	NCBI; cellular organisms; Eukaryota; Opisthokonta; Fungi; Dikarya; Basidiomycota; Agaricomycotina; Tremellomycetes; Tremellales; Cryptococcaceae; Cryptococcus; Cryptococcus neoformans species complex; Cryptococcus neoformans; Cryptococcus neoformans var. neoformans; Cryptococcus neoformans var. neoformans JEC21;
contig_310	NCBI; cellular organisms; Eukaryota; Opisthokonta; Fungi; Dikarya; Basidiomycota; Agaricomycotina; Tremellomycetes; Tremellales; Cryptococcaceae; Cryptococcus; Cryptococcus neoformans species complex; Cryptococcus neoformans; Cryptococcus neoformans var. neoformans; Cryptococcus neoformans var. neoformans JEC21;
contig_314	NCBI; cellular organisms; Eukaryota; Opisthokonta; Fungi; Dikarya; Basidiomycota; Agaricomycotina; Tremellomycetes; Tremellales; Cryptococcaceae; Cryptococcus; Cryptococcus neoformans species complex; Cryptococcus neoformans; Cryptococcus neoformans var. neoformans; Cryptococcus neoformans var. neoformans JEC21;
contig_316	NCBI; cellular organisms; Eukaryota; Opisthokonta; Fungi; Dikarya; Basidiomycota; Agaricomycotina; Tremellomycetes; Tremellales; Cryptococcaceae; Cryptococcus; Cryptococcus neoformans species complex; Cryptococcus neoformans; Cryptococcus neoformans var. neoformans; Cryptococcus neoformans var. neoformans JEC21;
contig_320	NCBI; cellular organisms; Eukaryota; Opisthokonta; Fungi; Dikarya; Basidiomycota; Agaricomycotina; Tremellomycetes; Tremellales; Cryptococcaceae; Cryptococcus; Cryptococcus neoformans species complex; Cryptococcus neoformans; Cryptococcus neoformans var. neoformans; Cryptococcus neoformans var. neoformans JEC21;
contig_322	NCBI; cellular organisms; Eukaryota; Opisthokonta; Fungi; Dikarya; Basidiomycota; Agaricomycotina; Tremellomycetes; Tremellales; Cryptococcaceae; Cryptococcus; Cryptococcus neoformans species complex; Cryptococcus neoformans; Cryptococcus neoformans var. neoformans; Cryptococcus neoformans var. neoformans JEC21;
contig_323	NCBI; cellular organisms; Eukaryota; Opisthokonta; Fungi; Dikarya; Basidiomycota; Agaricomycotina; Tremellomycetes; Tremellales; Cryptococcaceae; Cryptococcus; Cryptococcus neoformans species complex; Cryptococcus neoformans; Cryptococcus neoformans var. neoformans; Cryptococcus neoformans var. neoformans JEC21;
contig_325	NCBI; cellular organisms; Eukaryota; Opisthokonta; Fungi; Dikarya; Basidiomycota; Agaricomycotina; Tremellomycetes; Tremellales; Cryptococcaceae; Cryptococcus; Cryptococcus neoformans species complex; Cryptococcus neoformans; Cryptococcus neoformans var. neoformans; Cryptococcus neoformans var. neoformans JEC21;
contig_331	NCBI; cellular organisms; Eukaryota; Opisthokonta; Fungi; Dikarya; Basidiomycota; Agaricomycotina; Tremellomycetes; Tremellales; Cryptococcaceae; Cryptococcus; Cryptococcus neoformans species complex; Cryptococcus neoformans; Cryptococcus neoformans var. neoformans; Cryptococcus neoformans var. neoformans JEC21;
contig_334	NCBI; cellular organisms; Eukaryota; Opisthokonta; Fungi; Dikarya; Basidiomycota; Agaricomycotina; Tremellomycetes; Tremellales; Cryptococcaceae; Cryptococcus; Cryptococcus neoformans species complex; Cryptococcus neoformans; Cryptococcus neoformans var. neoformans; Cryptococcus neoformans var. neoformans JEC21;
contig_336	NCBI; cellular organisms; Eukaryota; Opisthokonta; Fungi; Dikarya; Basidiomycota; Agaricomycotina; Tremellomycetes; Tremellales; Cryptococcaceae; Cryptococcus; Cryptococcus neoformans species complex; Cryptococcus neoformans; Cryptococcus neoformans var. neoformans; Cryptococcus neoformans var. neoformans JEC21;
contig_338	NCBI; cellular organisms; Eukaryota; Opisthokonta; Fungi; Dikarya; Basidiomycota; Agaricomycotina; Tremellomycetes; Tremellales; Cryptococcaceae; Cryptococcus; Cryptococcus neoformans species complex; Cryptococcus neoformans; Cryptococcus neoformans var. neoformans; Cryptococcus neoformans var. neoformans JEC21;
contig_340	NCBI; cellular organisms; Eukaryota; Opisthokonta; Fungi; Dikarya; Basidiomycota; Agaricomycotina; Tremellomycetes; Tremellales; Cryptococcaceae; Cryptococcus; Cryptococcus neoformans species complex; Cryptococcus neoformans; Cryptococcus neoformans var. neoformans; Cryptococcus neoformans var. neoformans JEC21;
contig_342	NCBI; cellular organisms; Eukaryota; Opisthokonta; Fungi; Dikarya; Basidiomycota; Agaricomycotina; Tremellomycetes; Tremellales; Cryptococcaceae; Cryptococcus; Cryptococcus neoformans species complex; Cryptococcus neoformans; Cryptococcus neoformans var. neoformans; Cryptococcus neoformans var. neoformans JEC21;
contig_343	NCBI; cellular organisms; Eukaryota; Opisthokonta; Fungi; Dikarya; Basidiomycota; Agaricomycotina; Tremellomycetes; Tremellales; Cryptococcaceae; Cryptococcus; Cryptococcus neoformans species complex; Cryptococcus neoformans; Cryptococcus neoformans var. neoformans; Cryptococcus neoformans var. neoformans JEC21;
contig_344	NCBI; cellular organisms; Eukaryota; Opisthokonta; Fungi; Dikarya; Basidiomycota; Agaricomycotina; Tremellomycetes; Tremellales; Cryptococcaceae; Cryptococcus; Cryptococcus neoformans species complex; Cryptococcus neoformans; Cryptococcus neoformans var. neoformans; Cryptococcus neoformans var. neoformans JEC21;
contig_345	NCBI; cellular organisms; Eukaryota; Opisthokonta; Fungi; Dikarya; Basidiomycota; Agaricomycotina; Tremellomycetes; Tremellales; Cryptococcaceae; Cryptococcus; Cryptococcus neoformans species complex; Cryptococcus neoformans; Cryptococcus neoformans var. neoformans; Cryptococcus neoformans var. neoformans JEC21;
contig_349	NCBI; cellular organisms; Eukaryota; Opisthokonta; Fungi; Dikarya; Basidiomycota; Agaricomycotina; Tremellomycetes; Tremellales; Cryptococcaceae; Cryptococcus; Cryptococcus neoformans species complex; Cryptococcus neoformans; Cryptococcus neoformans var. neoformans; Cryptococcus neoformans var. neoformans JEC21;
contig_353	NCBI; cellular organisms; Eukaryota; Opisthokonta; Fungi; Dikarya; Basidiomycota; Agaricomycotina; Tremellomycetes; Tremellales; Cryptococcaceae; Cryptococcus; Cryptococcus neoformans species complex; Cryptococcus neoformans; Cryptococcus neoformans var. neoformans; Cryptococcus neoformans var. neoformans JEC21;
contig_355	NCBI; cellular organisms; Eukaryota; Opisthokonta; Fungi; Dikarya; Basidiomycota; Agaricomycotina; Tremellomycetes; Tremellales; Cryptococcaceae; Cryptococcus; Cryptococcus neoformans species complex; Cryptococcus neoformans; Cryptococcus neoformans var. neoformans; Cryptococcus neoformans var. neoformans JEC21;
contig_36	NCBI; cellular organisms; Eukaryota; Opisthokonta; Fungi; Dikarya; Basidiomycota; Agaricomycotina; Tremellomycetes; Tremellales; Cryptococcaceae; Cryptococcus; Cryptococcus neoformans species complex; Cryptococcus neoformans; Cryptococcus neoformans var. neoformans; Cryptococcus neoformans var. neoformans JEC21;
contig_361	NCBI; cellular organisms; Eukaryota; Opisthokonta; Fungi; Dikarya; Basidiomycota; Agaricomycotina; Tremellomycetes; Tremellales; Cryptococcaceae; Cryptococcus; Cryptococcus neoformans species complex; Cryptococcus neoformans; Cryptococcus neoformans var. neoformans; Cryptococcus neoformans var. neoformans JEC21;
contig_362	NCBI; cellular organisms; Eukaryota; Opisthokonta; Fungi; Dikarya; Basidiomycota; Agaricomycotina; Tremellomycetes; Tremellales; Cryptococcaceae; Cryptococcus; Cryptococcus neoformans species complex; Cryptococcus neoformans; Cryptococcus neoformans var. neoformans; Cryptococcus neoformans var. neoformans JEC21;
contig_367	NCBI; cellular organisms; Eukaryota; Opisthokonta; Fungi; Dikarya; Basidiomycota; Agaricomycotina; Tremellomycetes; Tremellales; Cryptococcaceae; Cryptococcus; Cryptococcus neoformans species complex; Cryptococcus neoformans; Cryptococcus neoformans var. neoformans; Cryptococcus neoformans var. neoformans JEC21;
contig_373	NCBI; cellular organisms; Eukaryota; Opisthokonta; Fungi; Dikarya; Basidiomycota; Agaricomycotina; Tremellomycetes; Tremellales; Cryptococcaceae; Cryptococcus; Cryptococcus neoformans species complex; Cryptococcus neoformans; Cryptococcus neoformans var. neoformans; Cryptococcus neoformans var. neoformans JEC21;
contig_379	NCBI; cellular organisms; Eukaryota; Opisthokonta; Fungi; Dikarya; Basidiomycota; Agaricomycotina; Tremellomycetes; Tremellales; Cryptococcaceae; Cryptococcus; Cryptococcus neoformans species complex; Cryptococcus neoformans; Cryptococcus neoformans var. neoformans; Cryptococcus neoformans var. neoformans JEC21;
contig_38	NCBI; cellular organisms; Eukaryota; Opisthokonta; Fungi; Dikarya; Basidiomycota; Agaricomycotina; Tremellomycetes; Tremellales; Cryptococcaceae; Cryptococcus; Cryptococcus neoformans species complex; Cryptococcus neoformans; Cryptococcus neoformans var. neoformans; Cryptococcus neoformans var. neoformans JEC21;
contig_380	NCBI; cellular organisms; Eukaryota; Opisthokonta; Fungi; Dikarya; Basidiomycota; Agaricomycotina; Tremellomycetes; Tremellales; Cryptococcaceae; Cryptococcus; Cryptococcus neoformans species complex; Cryptococcus neoformans; Cryptococcus neoformans var. neoformans; Cryptococcus neoformans var. neoformans JEC21;
contig_383	NCBI; cellular organisms; Eukaryota; Opisthokonta; Fungi; Dikarya; Basidiomycota; Agaricomycotina; Tremellomycetes; Tremellales; Cryptococcaceae; Cryptococcus; Cryptococcus neoformans species complex; Cryptococcus neoformans; Cryptococcus neoformans var. neoformans; Cryptococcus neoformans var. neoformans JEC21;
contig_388	NCBI; cellular organisms; Eukaryota; Opisthokonta; Fungi; Dikarya; Basidiomycota; Agaricomycotina; Tremellomycetes; Tremellales; Cryptococcaceae; Cryptococcus; Cryptococcus neoformans species complex; Cryptococcus neoformans; Cryptococcus neoformans var. neoformans; Cryptococcus neoformans var. neoformans JEC21;
contig_390	NCBI; cellular organisms; Eukaryota; Opisthokonta; Fungi; Dikarya; Basidiomycota; Agaricomycotina; Tremellomycetes; Tremellales; Cryptococcaceae; Cryptococcus; Cryptococcus neoformans species complex; Cryptococcus neoformans; Cryptococcus neoformans var. neoformans; Cryptococcus neoformans var. neoformans JEC21;
contig_394	NCBI; cellular organisms; Eukaryota; Opisthokonta; Fungi; Dikarya; Basidiomycota; Agaricomycotina; Tremellomycetes; Tremellales; Cryptococcaceae; Cryptococcus; Cryptococcus neoformans species complex; Cryptococcus neoformans; Cryptococcus neoformans var. neoformans; Cryptococcus neoformans var. neoformans JEC21;
contig_395	NCBI; cellular organisms; Eukaryota; Opisthokonta; Fungi; Dikarya; Basidiomycota; Agaricomycotina; Tremellomycetes; Tremellales; Cryptococcaceae; Cryptococcus; Cryptococcus neoformans species complex; Cryptococcus neoformans; Cryptococcus neoformans var. neoformans; Cryptococcus neoformans var. neoformans JEC21;
contig_399	NCBI; cellular organisms; Eukaryota; Opisthokonta; Fungi; Dikarya; Basidiomycota; Agaricomycotina; Tremellomycetes; Tremellales; Cryptococcaceae; Cryptococcus; Cryptococcus neoformans species complex; Cryptococcus neoformans; Cryptococcus neoformans var. neoformans; Cryptococcus neoformans var. neoformans JEC21;
contig_40	NCBI; cellular organisms; Eukaryota; Opisthokonta; Fungi; Dikarya; Basidiomycota; Agaricomycotina; Tremellomycetes; Tremellales; Cryptococcaceae; Cryptococcus; Cryptococcus neoformans species complex; Cryptococcus neoformans; Cryptococcus neoformans var. neoformans; Cryptococcus neoformans var. neoformans JEC21;
contig_403	NCBI; cellular organisms; Eukaryota; Opisthokonta; Fungi; Dikarya; Basidiomycota; Agaricomycotina; Tremellomycetes; Tremellales; Cryptococcaceae; Cryptococcus; Cryptococcus neoformans species complex; Cryptococcus neoformans; Cryptococcus neoformans var. neoformans; Cryptococcus neoformans var. neoformans JEC21;
contig_407	NCBI; cellular organisms; Eukaryota; Opisthokonta; Fungi; Dikarya; Basidiomycota; Agaricomycotina; Tremellomycetes; Tremellales; Cryptococcaceae; Cryptococcus; Cryptococcus neoformans species complex; Cryptococcus neoformans; Cryptococcus neoformans var. neoformans; Cryptococcus neoformans var. neoformans JEC21;
contig_41	NCBI; cellular organisms; Eukaryota; Opisthokonta; Fungi; Dikarya; Basidiomycota; Agaricomycotina; Tremellomycetes; Tremellales; Cryptococcaceae; Cryptococcus; Cryptococcus neoformans species complex; Cryptococcus neoformans; Cryptococcus neoformans var. neoformans; Cryptococcus neoformans var. neoformans JEC21;
contig_410	NCBI; cellular organisms; Eukaryota; Opisthokonta; Fungi; Dikarya; Basidiomycota; Agaricomycotina; Tremellomycetes; Tremellales; Cryptococcaceae; Cryptococcus; Cryptococcus neoformans species complex; Cryptococcus neoformans; Cryptococcus neoformans var. neoformans; Cryptococcus neoformans var. neoformans JEC21;
contig_411	NCBI; cellular organisms; Eukaryota; Opisthokonta; Fungi; Dikarya; Basidiomycota; Agaricomycotina; Tremellomycetes; Tremellales; Cryptococcaceae; Cryptococcus; Cryptococcus neoformans species complex; Cryptococcus neoformans; Cryptococcus neoformans var. neoformans; Cryptococcus neoformans var. neoformans JEC21;
contig_414	NCBI; cellular organisms; Eukaryota; Opisthokonta; Fungi; Dikarya; Basidiomycota; Agaricomycotina; Tremellomycetes; Tremellales; Cryptococcaceae; Cryptococcus; Cryptococcus neoformans species complex; Cryptococcus neoformans; Cryptococcus neoformans var. neoformans; Cryptococcus neoformans var. neoformans JEC21;
contig_418	NCBI; cellular organisms; Eukaryota; Opisthokonta; Fungi; Dikarya; Basidiomycota; Agaricomycotina; Tremellomycetes; Tremellales; Cryptococcaceae; Cryptococcus; Cryptococcus neoformans species complex; Cryptococcus neoformans; Cryptococcus neoformans var. neoformans; Cryptococcus neoformans var. neoformans JEC21;
contig_42	NCBI; cellular organisms; Eukaryota; Opisthokonta; Fungi; Dikarya; Basidiomycota; Agaricomycotina; Tremellomycetes; Tremellales; Cryptococcaceae; Cryptococcus; Cryptococcus neoformans species complex; Cryptococcus neoformans; Cryptococcus neoformans var. neoformans; Cryptococcus neoformans var. neoformans JEC21;
contig_422	NCBI; cellular organisms; Eukaryota; Opisthokonta; Fungi; Dikarya; Basidiomycota; Agaricomycotina; Tremellomycetes; Tremellales; Cryptococcaceae; Cryptococcus; Cryptococcus neoformans species complex; Cryptococcus neoformans; Cryptococcus neoformans var. neoformans; Cryptococcus neoformans var. neoformans JEC21;
contig_423	NCBI; cellular organisms; Eukaryota; Opisthokonta; Fungi; Dikarya; Basidiomycota; Agaricomycotina; Tremellomycetes; Tremellales; Cryptococcaceae; Cryptococcus; Cryptococcus neoformans species complex; Cryptococcus neoformans; Cryptococcus neoformans var. neoformans; Cryptococcus neoformans var. neoformans JEC21;
contig_426	NCBI; cellular organisms; Eukaryota; Opisthokonta; Fungi; Dikarya; Basidiomycota; Agaricomycotina; Tremellomycetes; Tremellales; Cryptococcaceae; Cryptococcus; Cryptococcus neoformans species complex; Cryptococcus neoformans; Cryptococcus neoformans var. neoformans; Cryptococcus neoformans var. neoformans JEC21;
contig_43	NCBI; cellular organisms; Eukaryota; Opisthokonta; Fungi; Dikarya; Basidiomycota; Agaricomycotina; Tremellomycetes; Tremellales; Cryptococcaceae; Cryptococcus; Cryptococcus neoformans species complex; Cryptococcus neoformans; Cryptococcus neoformans var. neoformans; Cryptococcus neoformans var. neoformans JEC21;
contig_433	NCBI; cellular organisms; Eukaryota; Opisthokonta; Fungi; Dikarya; Basidiomycota; Agaricomycotina; Tremellomycetes; Tremellales; Cryptococcaceae; Cryptococcus; Cryptococcus neoformans species complex; Cryptococcus neoformans; Cryptococcus neoformans var. neoformans; Cryptococcus neoformans var. neoformans JEC21;
contig_438	NCBI; cellular organisms; Eukaryota; Opisthokonta; Fungi; Dikarya; Basidiomycota; Agaricomycotina; Tremellomycetes; Tremellales; Cryptococcaceae; Cryptococcus; Cryptococcus neoformans species complex; Cryptococcus neoformans; Cryptococcus neoformans var. neoformans; Cryptococcus neoformans var. neoformans JEC21;
contig_439	NCBI; cellular organisms; Eukaryota; Opisthokonta; Fungi; Dikarya; Basidiomycota; Agaricomycotina; Tremellomycetes; Tremellales; Cryptococcaceae; Cryptococcus; Cryptococcus neoformans species complex; Cryptococcus neoformans; Cryptococcus neoformans var. neoformans; Cryptococcus neoformans var. neoformans JEC21;
contig_440	NCBI; cellular organisms; Eukaryota; Opisthokonta; Fungi; Dikarya; Basidiomycota; Agaricomycotina; Tremellomycetes; Tremellales; Cryptococcaceae; Cryptococcus; Cryptococcus neoformans species complex; Cryptococcus neoformans; Cryptococcus neoformans var. neoformans; Cryptococcus neoformans var. neoformans JEC21;
contig_441	NCBI; cellular organisms; Eukaryota; Opisthokonta; Fungi; Dikarya; Basidiomycota; Agaricomycotina; Tremellomycetes; Tremellales; Cryptococcaceae; Cryptococcus; Cryptococcus neoformans species complex; Cryptococcus neoformans; Cryptococcus neoformans var. neoformans; Cryptococcus neoformans var. neoformans JEC21;
contig_443	NCBI; cellular organisms; Eukaryota; Opisthokonta; Fungi; Dikarya; Basidiomycota; Agaricomycotina; Tremellomycetes; Tremellales; Cryptococcaceae; Cryptococcus; Cryptococcus neoformans species complex; Cryptococcus neoformans; Cryptococcus neoformans var. neoformans; Cryptococcus neoformans var. neoformans JEC21;
contig_444	NCBI; cellular organisms; Eukaryota; Opisthokonta; Fungi; Dikarya; Basidiomycota; Agaricomycotina; Tremellomycetes; Tremellales; Cryptococcaceae; Cryptococcus; Cryptococcus neoformans species complex; Cryptococcus neoformans; Cryptococcus neoformans var. neoformans; Cryptococcus neoformans var. neoformans JEC21;
contig_447	NCBI; cellular organisms; Eukaryota; Opisthokonta; Fungi; Dikarya; Basidiomycota; Agaricomycotina; Tremellomycetes; Tremellales; Cryptococcaceae; Cryptococcus; Cryptococcus neoformans species complex; Cryptococcus neoformans; Cryptococcus neoformans var. neoformans; Cryptococcus neoformans var. neoformans JEC21;
contig_448	NCBI; cellular organisms; Eukaryota; Opisthokonta; Fungi; Dikarya; Basidiomycota; Agaricomycotina; Tremellomycetes; Tremellales; Cryptococcaceae; Cryptococcus; Cryptococcus neoformans species complex; Cryptococcus neoformans; Cryptococcus neoformans var. neoformans; Cryptococcus neoformans var. neoformans JEC21;
contig_454	NCBI; cellular organisms; Eukaryota; Opisthokonta; Fungi; Dikarya; Basidiomycota; Agaricomycotina; Tremellomycetes; Tremellales; Cryptococcaceae; Cryptococcus; Cryptococcus neoformans species complex; Cryptococcus neoformans; Cryptococcus neoformans var. neoformans; Cryptococcus neoformans var. neoformans JEC21;
contig_455	NCBI; cellular organisms; Eukaryota; Opisthokonta; Fungi; Dikarya; Basidiomycota; Agaricomycotina; Tremellomycetes; Tremellales; Cryptococcaceae; Cryptococcus; Cryptococcus neoformans species complex; Cryptococcus neoformans; Cryptococcus neoformans var. neoformans; Cryptococcus neoformans var. neoformans JEC21;
contig_457	NCBI; cellular organisms; Eukaryota; Opisthokonta; Fungi; Dikarya; Basidiomycota; Agaricomycotina; Tremellomycetes; Tremellales; Cryptococcaceae; Cryptococcus; Cryptococcus neoformans species complex; Cryptococcus neoformans; Cryptococcus neoformans var. neoformans; Cryptococcus neoformans var. neoformans JEC21;
contig_458	NCBI; cellular organisms; Eukaryota; Opisthokonta; Fungi; Dikarya; Basidiomycota; Agaricomycotina; Tremellomycetes; Tremellales; Cryptococcaceae; Cryptococcus; Cryptococcus neoformans species complex; Cryptococcus neoformans; Cryptococcus neoformans var. neoformans; Cryptococcus neoformans var. neoformans JEC21;
contig_46	NCBI; cellular organisms; Eukaryota; Opisthokonta; Fungi; Dikarya; Basidiomycota; Agaricomycotina; Tremellomycetes; Tremellales; Cryptococcaceae; Cryptococcus; Cryptococcus neoformans species complex; Cryptococcus neoformans; Cryptococcus neoformans var. neoformans; Cryptococcus neoformans var. neoformans JEC21;
contig_463	NCBI; cellular organisms; Eukaryota; Opisthokonta; Fungi; Dikarya; Basidiomycota; Agaricomycotina; Tremellomycetes; Tremellales; Cryptococcaceae; Cryptococcus; Cryptococcus neoformans species complex; Cryptococcus neoformans; Cryptococcus neoformans var. neoformans; Cryptococcus neoformans var. neoformans JEC21;
contig_466	NCBI; cellular organisms; Eukaryota; Opisthokonta; Fungi; Dikarya; Basidiomycota; Agaricomycotina; Tremellomycetes; Tremellales; Cryptococcaceae; Cryptococcus; Cryptococcus neoformans species complex; Cryptococcus neoformans; Cryptococcus neoformans var. neoformans; Cryptococcus neoformans var. neoformans JEC21;
contig_468	NCBI; cellular organisms; Eukaryota; Opisthokonta; Fungi; Dikarya; Basidiomycota; Agaricomycotina; Tremellomycetes; Tremellales; Cryptococcaceae; Cryptococcus; Cryptococcus neoformans species complex; Cryptococcus neoformans; Cryptococcus neoformans var. neoformans; Cryptococcus neoformans var. neoformans JEC21;
contig_470	NCBI; cellular organisms; Eukaryota; Opisthokonta; Fungi; Dikarya; Basidiomycota; Agaricomycotina; Tremellomycetes; Tremellales; Cryptococcaceae; Cryptococcus; Cryptococcus neoformans species complex; Cryptococcus neoformans; Cryptococcus neoformans var. neoformans; Cryptococcus neoformans var. neoformans JEC21;
contig_471	NCBI; cellular organisms; Eukaryota; Opisthokonta; Fungi; Dikarya; Basidiomycota; Agaricomycotina; Tremellomycetes; Tremellales; Cryptococcaceae; Cryptococcus; Cryptococcus neoformans species complex; Cryptococcus neoformans; Cryptococcus neoformans var. neoformans; Cryptococcus neoformans var. neoformans JEC21;
contig_474	NCBI; cellular organisms; Eukaryota; Opisthokonta; Fungi; Dikarya; Basidiomycota; Agaricomycotina; Tremellomycetes; Tremellales; Cryptococcaceae; Cryptococcus; Cryptococcus neoformans species complex; Cryptococcus neoformans; Cryptococcus neoformans var. neoformans; Cryptococcus neoformans var. neoformans JEC21;
contig_475	NCBI; cellular organisms; Eukaryota; Opisthokonta; Fungi; Dikarya; Basidiomycota; Agaricomycotina; Tremellomycetes; Tremellales; Cryptococcaceae; Cryptococcus; Cryptococcus neoformans species complex; Cryptococcus neoformans; Cryptococcus neoformans var. neoformans; Cryptococcus neoformans var. neoformans JEC21;
contig_477	NCBI; cellular organisms; Eukaryota; Opisthokonta; Fungi; Dikarya; Basidiomycota; Agaricomycotina; Tremellomycetes; Tremellales; Cryptococcaceae; Cryptococcus; Cryptococcus neoformans species complex; Cryptococcus neoformans; Cryptococcus neoformans var. neoformans; Cryptococcus neoformans var. neoformans JEC21;
contig_480	NCBI; cellular organisms; Eukaryota; Opisthokonta; Fungi; Dikarya; Basidiomycota; Agaricomycotina; Tremellomycetes; Tremellales; Cryptococcaceae; Cryptococcus; Cryptococcus neoformans species complex; Cryptococcus neoformans; Cryptococcus neoformans var. neoformans; Cryptococcus neoformans var. neoformans JEC21;
contig_482	NCBI; cellular organisms; Eukaryota; Opisthokonta; Fungi; Dikarya; Basidiomycota; Agaricomycotina; Tremellomycetes; Tremellales; Cryptococcaceae; Cryptococcus; Cryptococcus neoformans species complex; Cryptococcus neoformans; Cryptococcus neoformans var. neoformans; Cryptococcus neoformans var. neoformans JEC21;
contig_485	NCBI; cellular organisms; Eukaryota; Opisthokonta; Fungi; Dikarya; Basidiomycota; Agaricomycotina; Tremellomycetes; Tremellales; Cryptococcaceae; Cryptococcus; Cryptococcus neoformans species complex; Cryptococcus neoformans; Cryptococcus neoformans var. neoformans; Cryptococcus neoformans var. neoformans JEC21;
contig_494	NCBI; cellular organisms; Eukaryota; Opisthokonta; Fungi; Dikarya; Basidiomycota; Agaricomycotina; Tremellomycetes; Tremellales; Cryptococcaceae; Cryptococcus; Cryptococcus neoformans species complex; Cryptococcus neoformans; Cryptococcus neoformans var. neoformans; Cryptococcus neoformans var. neoformans JEC21;
contig_504	NCBI; cellular organisms; Eukaryota; Opisthokonta; Fungi; Dikarya; Basidiomycota; Agaricomycotina; Tremellomycetes; Tremellales; Cryptococcaceae; Cryptococcus; Cryptococcus neoformans species complex; Cryptococcus neoformans; Cryptococcus neoformans var. neoformans; Cryptococcus neoformans var. neoformans JEC21;
contig_512	NCBI; cellular organisms; Eukaryota; Opisthokonta; Fungi; Dikarya; Basidiomycota; Agaricomycotina; Tremellomycetes; Tremellales; Cryptococcaceae; Cryptococcus; Cryptococcus neoformans species complex; Cryptococcus neoformans; Cryptococcus neoformans var. neoformans; Cryptococcus neoformans var. neoformans JEC21;
contig_513	NCBI; cellular organisms; Eukaryota; Opisthokonta; Fungi; Dikarya; Basidiomycota; Agaricomycotina; Tremellomycetes; Tremellales; Cryptococcaceae; Cryptococcus; Cryptococcus neoformans species complex; Cryptococcus neoformans; Cryptococcus neoformans var. neoformans; Cryptococcus neoformans var. neoformans JEC21;
contig_515	NCBI; cellular organisms; Eukaryota; Opisthokonta; Fungi; Dikarya; Basidiomycota; Agaricomycotina; Tremellomycetes; Tremellales; Cryptococcaceae; Cryptococcus; Cryptococcus neoformans species complex; Cryptococcus neoformans; Cryptococcus neoformans var. neoformans; Cryptococcus neoformans var. neoformans JEC21;
contig_516	NCBI; cellular organisms; Eukaryota; Opisthokonta; Fungi; Dikarya; Basidiomycota; Agaricomycotina; Tremellomycetes; Tremellales; Cryptococcaceae; Cryptococcus; Cryptococcus neoformans species complex; Cryptococcus neoformans; Cryptococcus neoformans var. neoformans; Cryptococcus neoformans var. neoformans JEC21;
contig_519	NCBI; cellular organisms; Eukaryota; Opisthokonta; Fungi; Dikarya; Basidiomycota; Agaricomycotina; Tremellomycetes; Tremellales; Cryptococcaceae; Cryptococcus; Cryptococcus neoformans species complex; Cryptococcus neoformans; Cryptococcus neoformans var. neoformans; Cryptococcus neoformans var. neoformans JEC21;
contig_521	NCBI; cellular organisms; Eukaryota; Opisthokonta; Fungi; Dikarya; Basidiomycota; Agaricomycotina; Tremellomycetes; Tremellales; Cryptococcaceae; Cryptococcus; Cryptococcus neoformans species complex; Cryptococcus neoformans; Cryptococcus neoformans var. neoformans; Cryptococcus neoformans var. neoformans JEC21;
contig_526	NCBI; cellular organisms; Eukaryota; Opisthokonta; Fungi; Dikarya; Basidiomycota; Agaricomycotina; Tremellomycetes; Tremellales; Cryptococcaceae; Cryptococcus; Cryptococcus neoformans species complex; Cryptococcus neoformans; Cryptococcus neoformans var. neoformans; Cryptococcus neoformans var. neoformans JEC21;
contig_528	NCBI; cellular organisms; Eukaryota; Opisthokonta; Fungi; Dikarya; Basidiomycota; Agaricomycotina; Tremellomycetes; Tremellales; Cryptococcaceae; Cryptococcus; Cryptococcus neoformans species complex; Cryptococcus neoformans; Cryptococcus neoformans var. neoformans; Cryptococcus neoformans var. neoformans JEC21;
contig_529	NCBI; cellular organisms; Eukaryota; Opisthokonta; Fungi; Dikarya; Basidiomycota; Agaricomycotina; Tremellomycetes; Tremellales; Cryptococcaceae; Cryptococcus; Cryptococcus neoformans species complex; Cryptococcus neoformans; Cryptococcus neoformans var. neoformans; Cryptococcus neoformans var. neoformans JEC21;
contig_53	NCBI; cellular organisms; Eukaryota; Opisthokonta; Fungi; Dikarya; Basidiomycota; Agaricomycotina; Tremellomycetes; Tremellales; Cryptococcaceae; Cryptococcus; Cryptococcus neoformans species complex; Cryptococcus neoformans; Cryptococcus neoformans var. neoformans; Cryptococcus neoformans var. neoformans JEC21;
contig_531	NCBI; cellular organisms; Eukaryota; Opisthokonta; Fungi; Dikarya; Basidiomycota; Agaricomycotina; Tremellomycetes; Tremellales; Cryptococcaceae; Cryptococcus; Cryptococcus neoformans species complex; Cryptococcus neoformans; Cryptococcus neoformans var. neoformans; Cryptococcus neoformans var. neoformans JEC21;
contig_533	NCBI; cellular organisms; Eukaryota; Opisthokonta; Fungi; Dikarya; Basidiomycota; Agaricomycotina; Tremellomycetes; Tremellales; Cryptococcaceae; Cryptococcus; Cryptococcus neoformans species complex; Cryptococcus neoformans; Cryptococcus neoformans var. neoformans; Cryptococcus neoformans var. neoformans JEC21;
contig_536	NCBI; cellular organisms; Eukaryota; Opisthokonta; Fungi; Dikarya; Basidiomycota; Agaricomycotina; Tremellomycetes; Tremellales; Cryptococcaceae; Cryptococcus; Cryptococcus neoformans species complex; Cryptococcus neoformans; Cryptococcus neoformans var. neoformans; Cryptococcus neoformans var. neoformans JEC21;
contig_541	NCBI; cellular organisms; Eukaryota; Opisthokonta; Fungi; Dikarya; Basidiomycota; Agaricomycotina; Tremellomycetes; Tremellales; Cryptococcaceae; Cryptococcus; Cryptococcus neoformans species complex; Cryptococcus neoformans; Cryptococcus neoformans var. neoformans; Cryptococcus neoformans var. neoformans JEC21;
contig_543	NCBI; cellular organisms; Eukaryota; Opisthokonta; Fungi; Dikarya; Basidiomycota; Agaricomycotina; Tremellomycetes; Tremellales; Cryptococcaceae; Cryptococcus; Cryptococcus neoformans species complex; Cryptococcus neoformans; Cryptococcus neoformans var. neoformans; Cryptococcus neoformans var. neoformans JEC21;
contig_546	NCBI; cellular organisms; Eukaryota; Opisthokonta; Fungi; Dikarya; Basidiomycota; Agaricomycotina; Tremellomycetes; Tremellales; Cryptococcaceae; Cryptococcus; Cryptococcus neoformans species complex; Cryptococcus neoformans; Cryptococcus neoformans var. neoformans; Cryptococcus neoformans var. neoformans JEC21;
contig_549	NCBI; cellular organisms; Eukaryota; Opisthokonta; Fungi; Dikarya; Basidiomycota; Agaricomycotina; Tremellomycetes; Tremellales; Cryptococcaceae; Cryptococcus; Cryptococcus neoformans species complex; Cryptococcus neoformans; Cryptococcus neoformans var. neoformans; Cryptococcus neoformans var. neoformans JEC21;
contig_55	NCBI; cellular organisms; Eukaryota; Opisthokonta; Fungi; Dikarya; Basidiomycota; Agaricomycotina; Tremellomycetes; Tremellales; Cryptococcaceae; Cryptococcus; Cryptococcus neoformans species complex; Cryptococcus neoformans; Cryptococcus neoformans var. neoformans; Cryptococcus neoformans var. neoformans JEC21;
contig_552	NCBI; cellular organisms; Eukaryota; Opisthokonta; Fungi; Dikarya; Basidiomycota; Agaricomycotina; Tremellomycetes; Tremellales; Cryptococcaceae; Cryptococcus; Cryptococcus neoformans species complex; Cryptococcus neoformans; Cryptococcus neoformans var. neoformans; Cryptococcus neoformans var. neoformans JEC21;
contig_556	NCBI; cellular organisms; Eukaryota; Opisthokonta; Fungi; Dikarya; Basidiomycota; Agaricomycotina; Tremellomycetes; Tremellales; Cryptococcaceae; Cryptococcus; Cryptococcus neoformans species complex; Cryptococcus neoformans; Cryptococcus neoformans var. neoformans; Cryptococcus neoformans var. neoformans JEC21;
contig_559	NCBI; cellular organisms; Eukaryota; Opisthokonta; Fungi; Dikarya; Basidiomycota; Agaricomycotina; Tremellomycetes; Tremellales; Cryptococcaceae; Cryptococcus; Cryptococcus neoformans species complex; Cryptococcus neoformans; Cryptococcus neoformans var. neoformans; Cryptococcus neoformans var. neoformans JEC21;
contig_56	NCBI; cellular organisms; Eukaryota; Opisthokonta; Fungi; Dikarya; Basidiomycota; Agaricomycotina; Tremellomycetes; Tremellales; Cryptococcaceae; Cryptococcus; Cryptococcus neoformans species complex; Cryptococcus neoformans; Cryptococcus neoformans var. neoformans; Cryptococcus neoformans var. neoformans JEC21;
contig_562	NCBI; cellular organisms; Eukaryota; Opisthokonta; Fungi; Dikarya; Basidiomycota; Agaricomycotina; Tremellomycetes; Tremellales; Cryptococcaceae; Cryptococcus; Cryptococcus neoformans species complex; Cryptococcus neoformans; Cryptococcus neoformans var. neoformans; Cryptococcus neoformans var. neoformans JEC21;
contig_565	NCBI; cellular organisms; Eukaryota; Opisthokonta; Fungi; Dikarya; Basidiomycota; Agaricomycotina; Tremellomycetes; Tremellales; Cryptococcaceae; Cryptococcus; Cryptococcus neoformans species complex; Cryptococcus neoformans; Cryptococcus neoformans var. neoformans; Cryptococcus neoformans var. neoformans JEC21;
contig_570	NCBI; cellular organisms; Eukaryota; Opisthokonta; Fungi; Dikarya; Basidiomycota; Agaricomycotina; Tremellomycetes; Tremellales; Cryptococcaceae; Cryptococcus; Cryptococcus neoformans species complex; Cryptococcus neoformans; Cryptococcus neoformans var. neoformans; Cryptococcus neoformans var. neoformans JEC21;
contig_576	NCBI; cellular organisms; Eukaryota; Opisthokonta; Fungi; Dikarya; Basidiomycota; Agaricomycotina; Tremellomycetes; Tremellales; Cryptococcaceae; Cryptococcus; Cryptococcus neoformans species complex; Cryptococcus neoformans; Cryptococcus neoformans var. neoformans; Cryptococcus neoformans var. neoformans JEC21;
contig_579	NCBI; cellular organisms; Eukaryota; Opisthokonta; Fungi; Dikarya; Basidiomycota; Agaricomycotina; Tremellomycetes; Tremellales; Cryptococcaceae; Cryptococcus; Cryptococcus neoformans species complex; Cryptococcus neoformans; Cryptococcus neoformans var. neoformans; Cryptococcus neoformans var. neoformans JEC21;
contig_587	NCBI; cellular organisms; Eukaryota; Opisthokonta; Fungi; Dikarya; Basidiomycota; Agaricomycotina; Tremellomycetes; Tremellales; Cryptococcaceae; Cryptococcus; Cryptococcus neoformans species complex; Cryptococcus neoformans; Cryptococcus neoformans var. neoformans; Cryptococcus neoformans var. neoformans JEC21;
contig_588	NCBI; cellular organisms; Eukaryota; Opisthokonta; Fungi; Dikarya; Basidiomycota; Agaricomycotina; Tremellomycetes; Tremellales; Cryptococcaceae; Cryptococcus; Cryptococcus neoformans species complex; Cryptococcus neoformans; Cryptococcus neoformans var. neoformans; Cryptococcus neoformans var. neoformans JEC21;
contig_59	NCBI; cellular organisms; Eukaryota; Opisthokonta; Fungi; Dikarya; Basidiomycota; Agaricomycotina; Tremellomycetes; Tremellales; Cryptococcaceae; Cryptococcus; Cryptococcus neoformans species complex; Cryptococcus neoformans; Cryptococcus neoformans var. neoformans; Cryptococcus neoformans var. neoformans JEC21;
contig_595	NCBI; cellular organisms; Eukaryota; Opisthokonta; Fungi; Dikarya; Basidiomycota; Agaricomycotina; Tremellomycetes; Tremellales; Cryptococcaceae; Cryptococcus; Cryptococcus neoformans species complex; Cryptococcus neoformans; Cryptococcus neoformans var. neoformans; Cryptococcus neoformans var. neoformans JEC21;
contig_597	NCBI; cellular organisms; Eukaryota; Opisthokonta; Fungi; Dikarya; Basidiomycota; Agaricomycotina; Tremellomycetes; Tremellales; Cryptococcaceae; Cryptococcus; Cryptococcus neoformans species complex; Cryptococcus neoformans; Cryptococcus neoformans var. neoformans; Cryptococcus neoformans var. neoformans JEC21;
contig_60	NCBI; cellular organisms; Eukaryota; Opisthokonta; Fungi; Dikarya; Basidiomycota; Agaricomycotina; Tremellomycetes; Tremellales; Cryptococcaceae; Cryptococcus; Cryptococcus neoformans species complex; Cryptococcus neoformans; Cryptococcus neoformans var. neoformans; Cryptococcus neoformans var. neoformans JEC21;
contig_600	NCBI; cellular organisms; Eukaryota; Opisthokonta; Fungi; Dikarya; Basidiomycota; Agaricomycotina; Tremellomycetes; Tremellales; Cryptococcaceae; Cryptococcus; Cryptococcus neoformans species complex; Cryptococcus neoformans; Cryptococcus neoformans var. neoformans; Cryptococcus neoformans var. neoformans JEC21;
contig_612	NCBI; cellular organisms; Eukaryota; Opisthokonta; Fungi; Dikarya; Basidiomycota; Agaricomycotina; Tremellomycetes; Tremellales; Cryptococcaceae; Cryptococcus; Cryptococcus neoformans species complex; Cryptococcus neoformans; Cryptococcus neoformans var. neoformans; Cryptococcus neoformans var. neoformans JEC21;
contig_613	NCBI; cellular organisms; Eukaryota; Opisthokonta; Fungi; Dikarya; Basidiomycota; Agaricomycotina; Tremellomycetes; Tremellales; Cryptococcaceae; Cryptococcus; Cryptococcus neoformans species complex; Cryptococcus neoformans; Cryptococcus neoformans var. neoformans; Cryptococcus neoformans var. neoformans JEC21;
contig_615	NCBI; cellular organisms; Eukaryota; Opisthokonta; Fungi; Dikarya; Basidiomycota; Agaricomycotina; Tremellomycetes; Tremellales; Cryptococcaceae; Cryptococcus; Cryptococcus neoformans species complex; Cryptococcus neoformans; Cryptococcus neoformans var. neoformans; Cryptococcus neoformans var. neoformans JEC21;
contig_617	NCBI; cellular organisms; Eukaryota; Opisthokonta; Fungi; Dikarya; Basidiomycota; Agaricomycotina; Tremellomycetes; Tremellales; Cryptococcaceae; Cryptococcus; Cryptococcus neoformans species complex; Cryptococcus neoformans; Cryptococcus neoformans var. neoformans; Cryptococcus neoformans var. neoformans JEC21;
contig_62	NCBI; cellular organisms; Eukaryota; Opisthokonta; Fungi; Dikarya; Basidiomycota; Agaricomycotina; Tremellomycetes; Tremellales; Cryptococcaceae; Cryptococcus; Cryptococcus neoformans species complex; Cryptococcus neoformans; Cryptococcus neoformans var. neoformans; Cryptococcus neoformans var. neoformans JEC21;
contig_620	NCBI; cellular organisms; Eukaryota; Opisthokonta; Fungi; Dikarya; Basidiomycota; Agaricomycotina; Tremellomycetes; Tremellales; Cryptococcaceae; Cryptococcus; Cryptococcus neoformans species complex; Cryptococcus neoformans; Cryptococcus neoformans var. neoformans; Cryptococcus neoformans var. neoformans JEC21;
contig_623	NCBI; cellular organisms; Eukaryota; Opisthokonta; Fungi; Dikarya; Basidiomycota; Agaricomycotina; Tremellomycetes; Tremellales; Cryptococcaceae; Cryptococcus; Cryptococcus neoformans species complex; Cryptococcus neoformans; Cryptococcus neoformans var. neoformans; Cryptococcus neoformans var. neoformans JEC21;
contig_630	NCBI; cellular organisms; Eukaryota; Opisthokonta; Fungi; Dikarya; Basidiomycota; Agaricomycotina; Tremellomycetes; Tremellales; Cryptococcaceae; Cryptococcus; Cryptococcus neoformans species complex; Cryptococcus neoformans; Cryptococcus neoformans var. neoformans; Cryptococcus neoformans var. neoformans JEC21;
contig_636	NCBI; cellular organisms; Eukaryota; Opisthokonta; Fungi; Dikarya; Basidiomycota; Agaricomycotina; Tremellomycetes; Tremellales; Cryptococcaceae; Cryptococcus; Cryptococcus neoformans species complex; Cryptococcus neoformans; Cryptococcus neoformans var. neoformans; Cryptococcus neoformans var. neoformans JEC21;
contig_638	NCBI; cellular organisms; Eukaryota; Opisthokonta; Fungi; Dikarya; Basidiomycota; Agaricomycotina; Tremellomycetes; Tremellales; Cryptococcaceae; Cryptococcus; Cryptococcus neoformans species complex; Cryptococcus neoformans; Cryptococcus neoformans var. neoformans; Cryptococcus neoformans var. neoformans JEC21;
contig_648	NCBI; cellular organisms; Eukaryota; Opisthokonta; Fungi; Dikarya; Basidiomycota; Agaricomycotina; Tremellomycetes; Tremellales; Cryptococcaceae; Cryptococcus; Cryptococcus neoformans species complex; Cryptococcus neoformans; Cryptococcus neoformans var. neoformans; Cryptococcus neoformans var. neoformans JEC21;
contig_649	NCBI; cellular organisms; Eukaryota; Opisthokonta; Fungi; Dikarya; Basidiomycota; Agaricomycotina; Tremellomycetes; Tremellales; Cryptococcaceae; Cryptococcus; Cryptococcus neoformans species complex; Cryptococcus neoformans; Cryptococcus neoformans var. neoformans; Cryptococcus neoformans var. neoformans JEC21;
contig_65	NCBI; cellular organisms; Eukaryota; Opisthokonta; Fungi; Dikarya; Basidiomycota; Agaricomycotina; Tremellomycetes; Tremellales; Cryptococcaceae; Cryptococcus; Cryptococcus neoformans species complex; Cryptococcus neoformans; Cryptococcus neoformans var. neoformans; Cryptococcus neoformans var. neoformans JEC21;
contig_650	NCBI; cellular organisms; Eukaryota; Opisthokonta; Fungi; Dikarya; Basidiomycota; Agaricomycotina; Tremellomycetes; Tremellales; Cryptococcaceae; Cryptococcus; Cryptococcus neoformans species complex; Cryptococcus neoformans; Cryptococcus neoformans var. neoformans; Cryptococcus neoformans var. neoformans JEC21;
contig_659	NCBI; cellular organisms; Eukaryota; Opisthokonta; Fungi; Dikarya; Basidiomycota; Agaricomycotina; Tremellomycetes; Tremellales; Cryptococcaceae; Cryptococcus; Cryptococcus neoformans species complex; Cryptococcus neoformans; Cryptococcus neoformans var. neoformans; Cryptococcus neoformans var. neoformans JEC21;
contig_665	NCBI; cellular organisms; Eukaryota; Opisthokonta; Fungi; Dikarya; Basidiomycota; Agaricomycotina; Tremellomycetes; Tremellales; Cryptococcaceae; Cryptococcus; Cryptococcus neoformans species complex; Cryptococcus neoformans; Cryptococcus neoformans var. neoformans; Cryptococcus neoformans var. neoformans JEC21;
contig_668	NCBI; cellular organisms; Eukaryota; Opisthokonta; Fungi; Dikarya; Basidiomycota; Agaricomycotina; Tremellomycetes; Tremellales; Cryptococcaceae; Cryptococcus; Cryptococcus neoformans species complex; Cryptococcus neoformans; Cryptococcus neoformans var. neoformans; Cryptococcus neoformans var. neoformans JEC21;
contig_67	NCBI; cellular organisms; Eukaryota; Opisthokonta; Fungi; Dikarya; Basidiomycota; Agaricomycotina; Tremellomycetes; Tremellales; Cryptococcaceae; Cryptococcus; Cryptococcus neoformans species complex; Cryptococcus neoformans; Cryptococcus neoformans var. neoformans; Cryptococcus neoformans var. neoformans JEC21;
contig_671	NCBI; cellular organisms; Eukaryota; Opisthokonta; Fungi; Dikarya; Basidiomycota; Agaricomycotina; Tremellomycetes; Tremellales; Cryptococcaceae; Cryptococcus; Cryptococcus neoformans species complex; Cryptococcus neoformans; Cryptococcus neoformans var. neoformans; Cryptococcus neoformans var. neoformans JEC21;
contig_672	NCBI; cellular organisms; Eukaryota; Opisthokonta; Fungi; Dikarya; Basidiomycota; Agaricomycotina; Tremellomycetes; Tremellales; Cryptococcaceae; Cryptococcus; Cryptococcus neoformans species complex; Cryptococcus neoformans; Cryptococcus neoformans var. neoformans; Cryptococcus neoformans var. neoformans JEC21;
contig_674	NCBI; cellular organisms; Eukaryota; Opisthokonta; Fungi; Dikarya; Basidiomycota; Agaricomycotina; Tremellomycetes; Tremellales; Cryptococcaceae; Cryptococcus; Cryptococcus neoformans species complex; Cryptococcus neoformans; Cryptococcus neoformans var. neoformans; Cryptococcus neoformans var. neoformans JEC21;
contig_68	NCBI; cellular organisms; Eukaryota; Opisthokonta; Fungi; Dikarya; Basidiomycota; Agaricomycotina; Tremellomycetes; Tremellales; Cryptococcaceae; Cryptococcus; Cryptococcus neoformans species complex; Cryptococcus neoformans; Cryptococcus neoformans var. neoformans; Cryptococcus neoformans var. neoformans JEC21;
contig_681	NCBI; cellular organisms; Eukaryota; Opisthokonta; Fungi; Dikarya; Basidiomycota; Agaricomycotina; Tremellomycetes; Tremellales; Cryptococcaceae; Cryptococcus; Cryptococcus neoformans species complex; Cryptococcus neoformans; Cryptococcus neoformans var. neoformans; Cryptococcus neoformans var. neoformans JEC21;
contig_685	NCBI; cellular organisms; Eukaryota; Opisthokonta; Fungi; Dikarya; Basidiomycota; Agaricomycotina; Tremellomycetes; Tremellales; Cryptococcaceae; Cryptococcus; Cryptococcus neoformans species complex; Cryptococcus neoformans; Cryptococcus neoformans var. neoformans; Cryptococcus neoformans var. neoformans JEC21;
contig_72	NCBI; cellular organisms; Eukaryota; Opisthokonta; Fungi; Dikarya; Basidiomycota; Agaricomycotina; Tremellomycetes; Tremellales; Cryptococcaceae; Cryptococcus; Cryptococcus neoformans species complex; Cryptococcus neoformans; Cryptococcus neoformans var. neoformans; Cryptococcus neoformans var. neoformans JEC21;
contig_75	NCBI; cellular organisms; Eukaryota; Opisthokonta; Fungi; Dikarya; Basidiomycota; Agaricomycotina; Tremellomycetes; Tremellales; Cryptococcaceae; Cryptococcus; Cryptococcus neoformans species complex; Cryptococcus neoformans; Cryptococcus neoformans var. neoformans; Cryptococcus neoformans var. neoformans JEC21;
contig_76	NCBI; cellular organisms; Eukaryota; Opisthokonta; Fungi; Dikarya; Basidiomycota; Agaricomycotina; Tremellomycetes; Tremellales; Cryptococcaceae; Cryptococcus; Cryptococcus neoformans species complex; Cryptococcus neoformans; Cryptococcus neoformans var. neoformans; Cryptococcus neoformans var. neoformans JEC21;
contig_77	NCBI; cellular organisms; Eukaryota; Opisthokonta; Fungi; Dikarya; Basidiomycota; Agaricomycotina; Tremellomycetes; Tremellales; Cryptococcaceae; Cryptococcus; Cryptococcus neoformans species complex; Cryptococcus neoformans; Cryptococcus neoformans var. neoformans; Cryptococcus neoformans var. neoformans JEC21;
contig_79	NCBI; cellular organisms; Eukaryota; Opisthokonta; Fungi; Dikarya; Basidiomycota; Agaricomycotina; Tremellomycetes; Tremellales; Cryptococcaceae; Cryptococcus; Cryptococcus neoformans species complex; Cryptococcus neoformans; Cryptococcus neoformans var. neoformans; Cryptococcus neoformans var. neoformans JEC21;
contig_84	NCBI; cellular organisms; Eukaryota; Opisthokonta; Fungi; Dikarya; Basidiomycota; Agaricomycotina; Tremellomycetes; Tremellales; Cryptococcaceae; Cryptococcus; Cryptococcus neoformans species complex; Cryptococcus neoformans; Cryptococcus neoformans var. neoformans; Cryptococcus neoformans var. neoformans JEC21;
contig_89	NCBI; cellular organisms; Eukaryota; Opisthokonta; Fungi; Dikarya; Basidiomycota; Agaricomycotina; Tremellomycetes; Tremellales; Cryptococcaceae; Cryptococcus; Cryptococcus neoformans species complex; Cryptococcus neoformans; Cryptococcus neoformans var. neoformans; Cryptococcus neoformans var. neoformans JEC21;
contig_90	NCBI; cellular organisms; Eukaryota; Opisthokonta; Fungi; Dikarya; Basidiomycota; Agaricomycotina; Tremellomycetes; Tremellales; Cryptococcaceae; Cryptococcus; Cryptococcus neoformans species complex; Cryptococcus neoformans; Cryptococcus neoformans var. neoformans; Cryptococcus neoformans var. neoformans JEC21;
contig_93	NCBI; cellular organisms; Eukaryota; Opisthokonta; Fungi; Dikarya; Basidiomycota; Agaricomycotina; Tremellomycetes; Tremellales; Cryptococcaceae; Cryptococcus; Cryptococcus neoformans species complex; Cryptococcus neoformans; Cryptococcus neoformans var. neoformans; Cryptococcus neoformans var. neoformans JEC21;
contig_101	NCBI; cellular organisms; Eukaryota; Opisthokonta; Fungi; Dikarya; Basidiomycota; Agaricomycotina; Tremellomycetes; Tremellales; Cryptococcaceae; Cryptococcus; Cryptococcus neoformans species complex; Cryptococcus neoformans; Cryptococcus neoformans var. grubii; Cryptococcus neoformans var. grubii H99;
contig_120	NCBI; cellular organisms; Eukaryota; Opisthokonta; Fungi; Dikarya; Basidiomycota; Agaricomycotina; Tremellomycetes; Tremellales; Cryptococcaceae; Cryptococcus; Cryptococcus neoformans species complex; Cryptococcus neoformans; Cryptococcus neoformans var. grubii; Cryptococcus neoformans var. grubii H99;
contig_124	NCBI; cellular organisms; Eukaryota; Opisthokonta; Fungi; Dikarya; Basidiomycota; Agaricomycotina; Tremellomycetes; Tremellales; Cryptococcaceae; Cryptococcus; Cryptococcus neoformans species complex; Cryptococcus neoformans; Cryptococcus neoformans var. grubii; Cryptococcus neoformans var. grubii H99;
contig_126	NCBI; cellular organisms; Eukaryota; Opisthokonta; Fungi; Dikarya; Basidiomycota; Agaricomycotina; Tremellomycetes; Tremellales; Cryptococcaceae; Cryptococcus; Cryptococcus neoformans species complex; Cryptococcus neoformans; Cryptococcus neoformans var. grubii; Cryptococcus neoformans var. grubii H99;
contig_134	NCBI; cellular organisms; Eukaryota; Opisthokonta; Fungi; Dikarya; Basidiomycota; Agaricomycotina; Tremellomycetes; Tremellales; Cryptococcaceae; Cryptococcus; Cryptococcus neoformans species complex; Cryptococcus neoformans; Cryptococcus neoformans var. grubii; Cryptococcus neoformans var. grubii H99;
contig_135	NCBI; cellular organisms; Eukaryota; Opisthokonta; Fungi; Dikarya; Basidiomycota; Agaricomycotina; Tremellomycetes; Tremellales; Cryptococcaceae; Cryptococcus; Cryptococcus neoformans species complex; Cryptococcus neoformans; Cryptococcus neoformans var. grubii; Cryptococcus neoformans var. grubii H99;
contig_146	NCBI; cellular organisms; Eukaryota; Opisthokonta; Fungi; Dikarya; Basidiomycota; Agaricomycotina; Tremellomycetes; Tremellales; Cryptococcaceae; Cryptococcus; Cryptococcus neoformans species complex; Cryptococcus neoformans; Cryptococcus neoformans var. grubii; Cryptococcus neoformans var. grubii H99;
contig_170	NCBI; cellular organisms; Eukaryota; Opisthokonta; Fungi; Dikarya; Basidiomycota; Agaricomycotina; Tremellomycetes; Tremellales; Cryptococcaceae; Cryptococcus; Cryptococcus neoformans species complex; Cryptococcus neoformans; Cryptococcus neoformans var. grubii; Cryptococcus neoformans var. grubii H99;
contig_174	NCBI; cellular organisms; Eukaryota; Opisthokonta; Fungi; Dikarya; Basidiomycota; Agaricomycotina; Tremellomycetes; Tremellales; Cryptococcaceae; Cryptococcus; Cryptococcus neoformans species complex; Cryptococcus neoformans; Cryptococcus neoformans var. grubii; Cryptococcus neoformans var. grubii H99;
contig_179	NCBI; cellular organisms; Eukaryota; Opisthokonta; Fungi; Dikarya; Basidiomycota; Agaricomycotina; Tremellomycetes; Tremellales; Cryptococcaceae; Cryptococcus; Cryptococcus neoformans species complex; Cryptococcus neoformans; Cryptococcus neoformans var. grubii; Cryptococcus neoformans var. grubii H99;
contig_180	NCBI; cellular organisms; Eukaryota; Opisthokonta; Fungi; Dikarya; Basidiomycota; Agaricomycotina; Tremellomycetes; Tremellales; Cryptococcaceae; Cryptococcus; Cryptococcus neoformans species complex; Cryptococcus neoformans; Cryptococcus neoformans var. grubii; Cryptococcus neoformans var. grubii H99;
contig_184	NCBI; cellular organisms; Eukaryota; Opisthokonta; Fungi; Dikarya; Basidiomycota; Agaricomycotina; Tremellomycetes; Tremellales; Cryptococcaceae; Cryptococcus; Cryptococcus neoformans species complex; Cryptococcus neoformans; Cryptococcus neoformans var. grubii; Cryptococcus neoformans var. grubii H99;
contig_189	NCBI; cellular organisms; Eukaryota; Opisthokonta; Fungi; Dikarya; Basidiomycota; Agaricomycotina; Tremellomycetes; Tremellales; Cryptococcaceae; Cryptococcus; Cryptococcus neoformans species complex; Cryptococcus neoformans; Cryptococcus neoformans var. grubii; Cryptococcus neoformans var. grubii H99;
contig_193	NCBI; cellular organisms; Eukaryota; Opisthokonta; Fungi; Dikarya; Basidiomycota; Agaricomycotina; Tremellomycetes; Tremellales; Cryptococcaceae; Cryptococcus; Cryptococcus neoformans species complex; Cryptococcus neoformans; Cryptococcus neoformans var. grubii; Cryptococcus neoformans var. grubii H99;
contig_200	NCBI; cellular organisms; Eukaryota; Opisthokonta; Fungi; Dikarya; Basidiomycota; Agaricomycotina; Tremellomycetes; Tremellales; Cryptococcaceae; Cryptococcus; Cryptococcus neoformans species complex; Cryptococcus neoformans; Cryptococcus neoformans var. grubii; Cryptococcus neoformans var. grubii H99;
contig_202	NCBI; cellular organisms; Eukaryota; Opisthokonta; Fungi; Dikarya; Basidiomycota; Agaricomycotina; Tremellomycetes; Tremellales; Cryptococcaceae; Cryptococcus; Cryptococcus neoformans species complex; Cryptococcus neoformans; Cryptococcus neoformans var. grubii; Cryptococcus neoformans var. grubii H99;
contig_214	NCBI; cellular organisms; Eukaryota; Opisthokonta; Fungi; Dikarya; Basidiomycota; Agaricomycotina; Tremellomycetes; Tremellales; Cryptococcaceae; Cryptococcus; Cryptococcus neoformans species complex; Cryptococcus neoformans; Cryptococcus neoformans var. grubii; Cryptococcus neoformans var. grubii H99;
contig_221	NCBI; cellular organisms; Eukaryota; Opisthokonta; Fungi; Dikarya; Basidiomycota; Agaricomycotina; Tremellomycetes; Tremellales; Cryptococcaceae; Cryptococcus; Cryptococcus neoformans species complex; Cryptococcus neoformans; Cryptococcus neoformans var. grubii; Cryptococcus neoformans var. grubii H99;
contig_231	NCBI; cellular organisms; Eukaryota; Opisthokonta; Fungi; Dikarya; Basidiomycota; Agaricomycotina; Tremellomycetes; Tremellales; Cryptococcaceae; Cryptococcus; Cryptococcus neoformans species complex; Cryptococcus neoformans; Cryptococcus neoformans var. grubii; Cryptococcus neoformans var. grubii H99;
contig_235	NCBI; cellular organisms; Eukaryota; Opisthokonta; Fungi; Dikarya; Basidiomycota; Agaricomycotina; Tremellomycetes; Tremellales; Cryptococcaceae; Cryptococcus; Cryptococcus neoformans species complex; Cryptococcus neoformans; Cryptococcus neoformans var. grubii; Cryptococcus neoformans var. grubii H99;
contig_237	NCBI; cellular organisms; Eukaryota; Opisthokonta; Fungi; Dikarya; Basidiomycota; Agaricomycotina; Tremellomycetes; Tremellales; Cryptococcaceae; Cryptococcus; Cryptococcus neoformans species complex; Cryptococcus neoformans; Cryptococcus neoformans var. grubii; Cryptococcus neoformans var. grubii H99;
contig_240	NCBI; cellular organisms; Eukaryota; Opisthokonta; Fungi; Dikarya; Basidiomycota; Agaricomycotina; Tremellomycetes; Tremellales; Cryptococcaceae; Cryptococcus; Cryptococcus neoformans species complex; Cryptococcus neoformans; Cryptococcus neoformans var. grubii; Cryptococcus neoformans var. grubii H99;
contig_243	NCBI; cellular organisms; Eukaryota; Opisthokonta; Fungi; Dikarya; Basidiomycota; Agaricomycotina; Tremellomycetes; Tremellales; Cryptococcaceae; Cryptococcus; Cryptococcus neoformans species complex; Cryptococcus neoformans; Cryptococcus neoformans var. grubii; Cryptococcus neoformans var. grubii H99;
contig_262	NCBI; cellular organisms; Eukaryota; Opisthokonta; Fungi; Dikarya; Basidiomycota; Agaricomycotina; Tremellomycetes; Tremellales; Cryptococcaceae; Cryptococcus; Cryptococcus neoformans species complex; Cryptococcus neoformans; Cryptococcus neoformans var. grubii; Cryptococcus neoformans var. grubii H99;
contig_263	NCBI; cellular organisms; Eukaryota; Opisthokonta; Fungi; Dikarya; Basidiomycota; Agaricomycotina; Tremellomycetes; Tremellales; Cryptococcaceae; Cryptococcus; Cryptococcus neoformans species complex; Cryptococcus neoformans; Cryptococcus neoformans var. grubii; Cryptococcus neoformans var. grubii H99;
contig_265	NCBI; cellular organisms; Eukaryota; Opisthokonta; Fungi; Dikarya; Basidiomycota; Agaricomycotina; Tremellomycetes; Tremellales; Cryptococcaceae; Cryptococcus; Cryptococcus neoformans species complex; Cryptococcus neoformans; Cryptococcus neoformans var. grubii; Cryptococcus neoformans var. grubii H99;
contig_266	NCBI; cellular organisms; Eukaryota; Opisthokonta; Fungi; Dikarya; Basidiomycota; Agaricomycotina; Tremellomycetes; Tremellales; Cryptococcaceae; Cryptococcus; Cryptococcus neoformans species complex; Cryptococcus neoformans; Cryptococcus neoformans var. grubii; Cryptococcus neoformans var. grubii H99;
contig_269	NCBI; cellular organisms; Eukaryota; Opisthokonta; Fungi; Dikarya; Basidiomycota; Agaricomycotina; Tremellomycetes; Tremellales; Cryptococcaceae; Cryptococcus; Cryptococcus neoformans species complex; Cryptococcus neoformans; Cryptococcus neoformans var. grubii; Cryptococcus neoformans var. grubii H99;
contig_270	NCBI; cellular organisms; Eukaryota; Opisthokonta; Fungi; Dikarya; Basidiomycota; Agaricomycotina; Tremellomycetes; Tremellales; Cryptococcaceae; Cryptococcus; Cryptococcus neoformans species complex; Cryptococcus neoformans; Cryptococcus neoformans var. grubii; Cryptococcus neoformans var. grubii H99;
contig_272	NCBI; cellular organisms; Eukaryota; Opisthokonta; Fungi; Dikarya; Basidiomycota; Agaricomycotina; Tremellomycetes; Tremellales; Cryptococcaceae; Cryptococcus; Cryptococcus neoformans species complex; Cryptococcus neoformans; Cryptococcus neoformans var. grubii; Cryptococcus neoformans var. grubii H99;
contig_273	NCBI; cellular organisms; Eukaryota; Opisthokonta; Fungi; Dikarya; Basidiomycota; Agaricomycotina; Tremellomycetes; Tremellales; Cryptococcaceae; Cryptococcus; Cryptococcus neoformans species complex; Cryptococcus neoformans; Cryptococcus neoformans var. grubii; Cryptococcus neoformans var. grubii H99;
contig_279	NCBI; cellular organisms; Eukaryota; Opisthokonta; Fungi; Dikarya; Basidiomycota; Agaricomycotina; Tremellomycetes; Tremellales; Cryptococcaceae; Cryptococcus; Cryptococcus neoformans species complex; Cryptococcus neoformans; Cryptococcus neoformans var. grubii; Cryptococcus neoformans var. grubii H99;
contig_281	NCBI; cellular organisms; Eukaryota; Opisthokonta; Fungi; Dikarya; Basidiomycota; Agaricomycotina; Tremellomycetes; Tremellales; Cryptococcaceae; Cryptococcus; Cryptococcus neoformans species complex; Cryptococcus neoformans; Cryptococcus neoformans var. grubii; Cryptococcus neoformans var. grubii H99;
contig_291	NCBI; cellular organisms; Eukaryota; Opisthokonta; Fungi; Dikarya; Basidiomycota; Agaricomycotina; Tremellomycetes; Tremellales; Cryptococcaceae; Cryptococcus; Cryptococcus neoformans species complex; Cryptococcus neoformans; Cryptococcus neoformans var. grubii; Cryptococcus neoformans var. grubii H99;
contig_293	NCBI; cellular organisms; Eukaryota; Opisthokonta; Fungi; Dikarya; Basidiomycota; Agaricomycotina; Tremellomycetes; Tremellales; Cryptococcaceae; Cryptococcus; Cryptococcus neoformans species complex; Cryptococcus neoformans; Cryptococcus neoformans var. grubii; Cryptococcus neoformans var. grubii H99;
contig_302	NCBI; cellular organisms; Eukaryota; Opisthokonta; Fungi; Dikarya; Basidiomycota; Agaricomycotina; Tremellomycetes; Tremellales; Cryptococcaceae; Cryptococcus; Cryptococcus neoformans species complex; Cryptococcus neoformans; Cryptococcus neoformans var. grubii; Cryptococcus neoformans var. grubii H99;
contig_305	NCBI; cellular organisms; Eukaryota; Opisthokonta; Fungi; Dikarya; Basidiomycota; Agaricomycotina; Tremellomycetes; Tremellales; Cryptococcaceae; Cryptococcus; Cryptococcus neoformans species complex; Cryptococcus neoformans; Cryptococcus neoformans var. grubii; Cryptococcus neoformans var. grubii H99;
contig_309	NCBI; cellular organisms; Eukaryota; Opisthokonta; Fungi; Dikarya; Basidiomycota; Agaricomycotina; Tremellomycetes; Tremellales; Cryptococcaceae; Cryptococcus; Cryptococcus neoformans species complex; Cryptococcus neoformans; Cryptococcus neoformans var. grubii; Cryptococcus neoformans var. grubii H99;
contig_312	NCBI; cellular organisms; Eukaryota; Opisthokonta; Fungi; Dikarya; Basidiomycota; Agaricomycotina; Tremellomycetes; Tremellales; Cryptococcaceae; Cryptococcus; Cryptococcus neoformans species complex; Cryptococcus neoformans; Cryptococcus neoformans var. grubii; Cryptococcus neoformans var. grubii H99;
contig_318	NCBI; cellular organisms; Eukaryota; Opisthokonta; Fungi; Dikarya; Basidiomycota; Agaricomycotina; Tremellomycetes; Tremellales; Cryptococcaceae; Cryptococcus; Cryptococcus neoformans species complex; Cryptococcus neoformans; Cryptococcus neoformans var. grubii; Cryptococcus neoformans var. grubii H99;
contig_321	NCBI; cellular organisms; Eukaryota; Opisthokonta; Fungi; Dikarya; Basidiomycota; Agaricomycotina; Tremellomycetes; Tremellales; Cryptococcaceae; Cryptococcus; Cryptococcus neoformans species complex; Cryptococcus neoformans; Cryptococcus neoformans var. grubii; Cryptococcus neoformans var. grubii H99;
contig_324	NCBI; cellular organisms; Eukaryota; Opisthokonta; Fungi; Dikarya; Basidiomycota; Agaricomycotina; Tremellomycetes; Tremellales; Cryptococcaceae; Cryptococcus; Cryptococcus neoformans species complex; Cryptococcus neoformans; Cryptococcus neoformans var. grubii; Cryptococcus neoformans var. grubii H99;
contig_326	NCBI; cellular organisms; Eukaryota; Opisthokonta; Fungi; Dikarya; Basidiomycota; Agaricomycotina; Tremellomycetes; Tremellales; Cryptococcaceae; Cryptococcus; Cryptococcus neoformans species complex; Cryptococcus neoformans; Cryptococcus neoformans var. grubii; Cryptococcus neoformans var. grubii H99;
contig_327	NCBI; cellular organisms; Eukaryota; Opisthokonta; Fungi; Dikarya; Basidiomycota; Agaricomycotina; Tremellomycetes; Tremellales; Cryptococcaceae; Cryptococcus; Cryptococcus neoformans species complex; Cryptococcus neoformans; Cryptococcus neoformans var. grubii; Cryptococcus neoformans var. grubii H99;
contig_332	NCBI; cellular organisms; Eukaryota; Opisthokonta; Fungi; Dikarya; Basidiomycota; Agaricomycotina; Tremellomycetes; Tremellales; Cryptococcaceae; Cryptococcus; Cryptococcus neoformans species complex; Cryptococcus neoformans; Cryptococcus neoformans var. grubii; Cryptococcus neoformans var. grubii H99;
contig_335	NCBI; cellular organisms; Eukaryota; Opisthokonta; Fungi; Dikarya; Basidiomycota; Agaricomycotina; Tremellomycetes; Tremellales; Cryptococcaceae; Cryptococcus; Cryptococcus neoformans species complex; Cryptococcus neoformans; Cryptococcus neoformans var. grubii; Cryptococcus neoformans var. grubii H99;
contig_339	NCBI; cellular organisms; Eukaryota; Opisthokonta; Fungi; Dikarya; Basidiomycota; Agaricomycotina; Tremellomycetes; Tremellales; Cryptococcaceae; Cryptococcus; Cryptococcus neoformans species complex; Cryptococcus neoformans; Cryptococcus neoformans var. grubii; Cryptococcus neoformans var. grubii H99;
contig_348	NCBI; cellular organisms; Eukaryota; Opisthokonta; Fungi; Dikarya; Basidiomycota; Agaricomycotina; Tremellomycetes; Tremellales; Cryptococcaceae; Cryptococcus; Cryptococcus neoformans species complex; Cryptococcus neoformans; Cryptococcus neoformans var. grubii; Cryptococcus neoformans var. grubii H99;
contig_35	NCBI; cellular organisms; Eukaryota; Opisthokonta; Fungi; Dikarya; Basidiomycota; Agaricomycotina; Tremellomycetes; Tremellales; Cryptococcaceae; Cryptococcus; Cryptococcus neoformans species complex; Cryptococcus neoformans; Cryptococcus neoformans var. grubii; Cryptococcus neoformans var. grubii H99;
contig_354	NCBI; cellular organisms; Eukaryota; Opisthokonta; Fungi; Dikarya; Basidiomycota; Agaricomycotina; Tremellomycetes; Tremellales; Cryptococcaceae; Cryptococcus; Cryptococcus neoformans species complex; Cryptococcus neoformans; Cryptococcus neoformans var. grubii; Cryptococcus neoformans var. grubii H99;
contig_356	NCBI; cellular organisms; Eukaryota; Opisthokonta; Fungi; Dikarya; Basidiomycota; Agaricomycotina; Tremellomycetes; Tremellales; Cryptococcaceae; Cryptococcus; Cryptococcus neoformans species complex; Cryptococcus neoformans; Cryptococcus neoformans var. grubii; Cryptococcus neoformans var. grubii H99;
contig_357	NCBI; cellular organisms; Eukaryota; Opisthokonta; Fungi; Dikarya; Basidiomycota; Agaricomycotina; Tremellomycetes; Tremellales; Cryptococcaceae; Cryptococcus; Cryptococcus neoformans species complex; Cryptococcus neoformans; Cryptococcus neoformans var. grubii; Cryptococcus neoformans var. grubii H99;
contig_359	NCBI; cellular organisms; Eukaryota; Opisthokonta; Fungi; Dikarya; Basidiomycota; Agaricomycotina; Tremellomycetes; Tremellales; Cryptococcaceae; Cryptococcus; Cryptococcus neoformans species complex; Cryptococcus neoformans; Cryptococcus neoformans var. grubii; Cryptococcus neoformans var. grubii H99;
contig_360	NCBI; cellular organisms; Eukaryota; Opisthokonta; Fungi; Dikarya; Basidiomycota; Agaricomycotina; Tremellomycetes; Tremellales; Cryptococcaceae; Cryptococcus; Cryptococcus neoformans species complex; Cryptococcus neoformans; Cryptococcus neoformans var. grubii; Cryptococcus neoformans var. grubii H99;
contig_371	NCBI; cellular organisms; Eukaryota; Opisthokonta; Fungi; Dikarya; Basidiomycota; Agaricomycotina; Tremellomycetes; Tremellales; Cryptococcaceae; Cryptococcus; Cryptococcus neoformans species complex; Cryptococcus neoformans; Cryptococcus neoformans var. grubii; Cryptococcus neoformans var. grubii H99;
contig_381	NCBI; cellular organisms; Eukaryota; Opisthokonta; Fungi; Dikarya; Basidiomycota; Agaricomycotina; Tremellomycetes; Tremellales; Cryptococcaceae; Cryptococcus; Cryptococcus neoformans species complex; Cryptococcus neoformans; Cryptococcus neoformans var. grubii; Cryptococcus neoformans var. grubii H99;
contig_382	NCBI; cellular organisms; Eukaryota; Opisthokonta; Fungi; Dikarya; Basidiomycota; Agaricomycotina; Tremellomycetes; Tremellales; Cryptococcaceae; Cryptococcus; Cryptococcus neoformans species complex; Cryptococcus neoformans; Cryptococcus neoformans var. grubii; Cryptococcus neoformans var. grubii H99;
contig_389	NCBI; cellular organisms; Eukaryota; Opisthokonta; Fungi; Dikarya; Basidiomycota; Agaricomycotina; Tremellomycetes; Tremellales; Cryptococcaceae; Cryptococcus; Cryptococcus neoformans species complex; Cryptococcus neoformans; Cryptococcus neoformans var. grubii; Cryptococcus neoformans var. grubii H99;
contig_393	NCBI; cellular organisms; Eukaryota; Opisthokonta; Fungi; Dikarya; Basidiomycota; Agaricomycotina; Tremellomycetes; Tremellales; Cryptococcaceae; Cryptococcus; Cryptococcus neoformans species complex; Cryptococcus neoformans; Cryptococcus neoformans var. grubii; Cryptococcus neoformans var. grubii H99;
contig_396	NCBI; cellular organisms; Eukaryota; Opisthokonta; Fungi; Dikarya; Basidiomycota; Agaricomycotina; Tremellomycetes; Tremellales; Cryptococcaceae; Cryptococcus; Cryptococcus neoformans species complex; Cryptococcus neoformans; Cryptococcus neoformans var. grubii; Cryptococcus neoformans var. grubii H99;
contig_397	NCBI; cellular organisms; Eukaryota; Opisthokonta; Fungi; Dikarya; Basidiomycota; Agaricomycotina; Tremellomycetes; Tremellales; Cryptococcaceae; Cryptococcus; Cryptococcus neoformans species complex; Cryptococcus neoformans; Cryptococcus neoformans var. grubii; Cryptococcus neoformans var. grubii H99;
contig_400	NCBI; cellular organisms; Eukaryota; Opisthokonta; Fungi; Dikarya; Basidiomycota; Agaricomycotina; Tremellomycetes; Tremellales; Cryptococcaceae; Cryptococcus; Cryptococcus neoformans species complex; Cryptococcus neoformans; Cryptococcus neoformans var. grubii; Cryptococcus neoformans var. grubii H99;
contig_404	NCBI; cellular organisms; Eukaryota; Opisthokonta; Fungi; Dikarya; Basidiomycota; Agaricomycotina; Tremellomycetes; Tremellales; Cryptococcaceae; Cryptococcus; Cryptococcus neoformans species complex; Cryptococcus neoformans; Cryptococcus neoformans var. grubii; Cryptococcus neoformans var. grubii H99;
contig_415	NCBI; cellular organisms; Eukaryota; Opisthokonta; Fungi; Dikarya; Basidiomycota; Agaricomycotina; Tremellomycetes; Tremellales; Cryptococcaceae; Cryptococcus; Cryptococcus neoformans species complex; Cryptococcus neoformans; Cryptococcus neoformans var. grubii; Cryptococcus neoformans var. grubii H99;
contig_419	NCBI; cellular organisms; Eukaryota; Opisthokonta; Fungi; Dikarya; Basidiomycota; Agaricomycotina; Tremellomycetes; Tremellales; Cryptococcaceae; Cryptococcus; Cryptococcus neoformans species complex; Cryptococcus neoformans; Cryptococcus neoformans var. grubii; Cryptococcus neoformans var. grubii H99;
contig_424	NCBI; cellular organisms; Eukaryota; Opisthokonta; Fungi; Dikarya; Basidiomycota; Agaricomycotina; Tremellomycetes; Tremellales; Cryptococcaceae; Cryptococcus; Cryptococcus neoformans species complex; Cryptococcus neoformans; Cryptococcus neoformans var. grubii; Cryptococcus neoformans var. grubii H99;
contig_429	NCBI; cellular organisms; Eukaryota; Opisthokonta; Fungi; Dikarya; Basidiomycota; Agaricomycotina; Tremellomycetes; Tremellales; Cryptococcaceae; Cryptococcus; Cryptococcus neoformans species complex; Cryptococcus neoformans; Cryptococcus neoformans var. grubii; Cryptococcus neoformans var. grubii H99;
contig_430	NCBI; cellular organisms; Eukaryota; Opisthokonta; Fungi; Dikarya; Basidiomycota; Agaricomycotina; Tremellomycetes; Tremellales; Cryptococcaceae; Cryptococcus; Cryptococcus neoformans species complex; Cryptococcus neoformans; Cryptococcus neoformans var. grubii; Cryptococcus neoformans var. grubii H99;
contig_436	NCBI; cellular organisms; Eukaryota; Opisthokonta; Fungi; Dikarya; Basidiomycota; Agaricomycotina; Tremellomycetes; Tremellales; Cryptococcaceae; Cryptococcus; Cryptococcus neoformans species complex; Cryptococcus neoformans; Cryptococcus neoformans var. grubii; Cryptococcus neoformans var. grubii H99;
contig_44	NCBI; cellular organisms; Eukaryota; Opisthokonta; Fungi; Dikarya; Basidiomycota; Agaricomycotina; Tremellomycetes; Tremellales; Cryptococcaceae; Cryptococcus; Cryptococcus neoformans species complex; Cryptococcus neoformans; Cryptococcus neoformans var. grubii; Cryptococcus neoformans var. grubii H99;
contig_445	NCBI; cellular organisms; Eukaryota; Opisthokonta; Fungi; Dikarya; Basidiomycota; Agaricomycotina; Tremellomycetes; Tremellales; Cryptococcaceae; Cryptococcus; Cryptococcus neoformans species complex; Cryptococcus neoformans; Cryptococcus neoformans var. grubii; Cryptococcus neoformans var. grubii H99;
contig_446	NCBI; cellular organisms; Eukaryota; Opisthokonta; Fungi; Dikarya; Basidiomycota; Agaricomycotina; Tremellomycetes; Tremellales; Cryptococcaceae; Cryptococcus; Cryptococcus neoformans species complex; Cryptococcus neoformans; Cryptococcus neoformans var. grubii; Cryptococcus neoformans var. grubii H99;
contig_450	NCBI; cellular organisms; Eukaryota; Opisthokonta; Fungi; Dikarya; Basidiomycota; Agaricomycotina; Tremellomycetes; Tremellales; Cryptococcaceae; Cryptococcus; Cryptococcus neoformans species complex; Cryptococcus neoformans; Cryptococcus neoformans var. grubii; Cryptococcus neoformans var. grubii H99;
contig_459	NCBI; cellular organisms; Eukaryota; Opisthokonta; Fungi; Dikarya; Basidiomycota; Agaricomycotina; Tremellomycetes; Tremellales; Cryptococcaceae; Cryptococcus; Cryptococcus neoformans species complex; Cryptococcus neoformans; Cryptococcus neoformans var. grubii; Cryptococcus neoformans var. grubii H99;
contig_461	NCBI; cellular organisms; Eukaryota; Opisthokonta; Fungi; Dikarya; Basidiomycota; Agaricomycotina; Tremellomycetes; Tremellales; Cryptococcaceae; Cryptococcus; Cryptococcus neoformans species complex; Cryptococcus neoformans; Cryptococcus neoformans var. grubii; Cryptococcus neoformans var. grubii H99;
contig_462	NCBI; cellular organisms; Eukaryota; Opisthokonta; Fungi; Dikarya; Basidiomycota; Agaricomycotina; Tremellomycetes; Tremellales; Cryptococcaceae; Cryptococcus; Cryptococcus neoformans species complex; Cryptococcus neoformans; Cryptococcus neoformans var. grubii; Cryptococcus neoformans var. grubii H99;
contig_464	NCBI; cellular organisms; Eukaryota; Opisthokonta; Fungi; Dikarya; Basidiomycota; Agaricomycotina; Tremellomycetes; Tremellales; Cryptococcaceae; Cryptococcus; Cryptococcus neoformans species complex; Cryptococcus neoformans; Cryptococcus neoformans var. grubii; Cryptococcus neoformans var. grubii H99;
contig_47	NCBI; cellular organisms; Eukaryota; Opisthokonta; Fungi; Dikarya; Basidiomycota; Agaricomycotina; Tremellomycetes; Tremellales; Cryptococcaceae; Cryptococcus; Cryptococcus neoformans species complex; Cryptococcus neoformans; Cryptococcus neoformans var. grubii; Cryptococcus neoformans var. grubii H99;
contig_476	NCBI; cellular organisms; Eukaryota; Opisthokonta; Fungi; Dikarya; Basidiomycota; Agaricomycotina; Tremellomycetes; Tremellales; Cryptococcaceae; Cryptococcus; Cryptococcus neoformans species complex; Cryptococcus neoformans; Cryptococcus neoformans var. grubii; Cryptococcus neoformans var. grubii H99;
contig_478	NCBI; cellular organisms; Eukaryota; Opisthokonta; Fungi; Dikarya; Basidiomycota; Agaricomycotina; Tremellomycetes; Tremellales; Cryptococcaceae; Cryptococcus; Cryptococcus neoformans species complex; Cryptococcus neoformans; Cryptococcus neoformans var. grubii; Cryptococcus neoformans var. grubii H99;
contig_479	NCBI; cellular organisms; Eukaryota; Opisthokonta; Fungi; Dikarya; Basidiomycota; Agaricomycotina; Tremellomycetes; Tremellales; Cryptococcaceae; Cryptococcus; Cryptococcus neoformans species complex; Cryptococcus neoformans; Cryptococcus neoformans var. grubii; Cryptococcus neoformans var. grubii H99;
contig_481	NCBI; cellular organisms; Eukaryota; Opisthokonta; Fungi; Dikarya; Basidiomycota; Agaricomycotina; Tremellomycetes; Tremellales; Cryptococcaceae; Cryptococcus; Cryptococcus neoformans species complex; Cryptococcus neoformans; Cryptococcus neoformans var. grubii; Cryptococcus neoformans var. grubii H99;
contig_483	NCBI; cellular organisms; Eukaryota; Opisthokonta; Fungi; Dikarya; Basidiomycota; Agaricomycotina; Tremellomycetes; Tremellales; Cryptococcaceae; Cryptococcus; Cryptococcus neoformans species complex; Cryptococcus neoformans; Cryptococcus neoformans var. grubii; Cryptococcus neoformans var. grubii H99;
contig_484	NCBI; cellular organisms; Eukaryota; Opisthokonta; Fungi; Dikarya; Basidiomycota; Agaricomycotina; Tremellomycetes; Tremellales; Cryptococcaceae; Cryptococcus; Cryptococcus neoformans species complex; Cryptococcus neoformans; Cryptococcus neoformans var. grubii; Cryptococcus neoformans var. grubii H99;
contig_488	NCBI; cellular organisms; Eukaryota; Opisthokonta; Fungi; Dikarya; Basidiomycota; Agaricomycotina; Tremellomycetes; Tremellales; Cryptococcaceae; Cryptococcus; Cryptococcus neoformans species complex; Cryptococcus neoformans; Cryptococcus neoformans var. grubii; Cryptococcus neoformans var. grubii H99;
contig_489	NCBI; cellular organisms; Eukaryota; Opisthokonta; Fungi; Dikarya; Basidiomycota; Agaricomycotina; Tremellomycetes; Tremellales; Cryptococcaceae; Cryptococcus; Cryptococcus neoformans species complex; Cryptococcus neoformans; Cryptococcus neoformans var. grubii; Cryptococcus neoformans var. grubii H99;
contig_490	NCBI; cellular organisms; Eukaryota; Opisthokonta; Fungi; Dikarya; Basidiomycota; Agaricomycotina; Tremellomycetes; Tremellales; Cryptococcaceae; Cryptococcus; Cryptococcus neoformans species complex; Cryptococcus neoformans; Cryptococcus neoformans var. grubii; Cryptococcus neoformans var. grubii H99;
contig_491	NCBI; cellular organisms; Eukaryota; Opisthokonta; Fungi; Dikarya; Basidiomycota; Agaricomycotina; Tremellomycetes; Tremellales; Cryptococcaceae; Cryptococcus; Cryptococcus neoformans species complex; Cryptococcus neoformans; Cryptococcus neoformans var. grubii; Cryptococcus neoformans var. grubii H99;
contig_492	NCBI; cellular organisms; Eukaryota; Opisthokonta; Fungi; Dikarya; Basidiomycota; Agaricomycotina; Tremellomycetes; Tremellales; Cryptococcaceae; Cryptococcus; Cryptococcus neoformans species complex; Cryptococcus neoformans; Cryptococcus neoformans var. grubii; Cryptococcus neoformans var. grubii H99;
contig_495	NCBI; cellular organisms; Eukaryota; Opisthokonta; Fungi; Dikarya; Basidiomycota; Agaricomycotina; Tremellomycetes; Tremellales; Cryptococcaceae; Cryptococcus; Cryptococcus neoformans species complex; Cryptococcus neoformans; Cryptococcus neoformans var. grubii; Cryptococcus neoformans var. grubii H99;
contig_497	NCBI; cellular organisms; Eukaryota; Opisthokonta; Fungi; Dikarya; Basidiomycota; Agaricomycotina; Tremellomycetes; Tremellales; Cryptococcaceae; Cryptococcus; Cryptococcus neoformans species complex; Cryptococcus neoformans; Cryptococcus neoformans var. grubii; Cryptococcus neoformans var. grubii H99;
contig_498	NCBI; cellular organisms; Eukaryota; Opisthokonta; Fungi; Dikarya; Basidiomycota; Agaricomycotina; Tremellomycetes; Tremellales; Cryptococcaceae; Cryptococcus; Cryptococcus neoformans species complex; Cryptococcus neoformans; Cryptococcus neoformans var. grubii; Cryptococcus neoformans var. grubii H99;
contig_499	NCBI; cellular organisms; Eukaryota; Opisthokonta; Fungi; Dikarya; Basidiomycota; Agaricomycotina; Tremellomycetes; Tremellales; Cryptococcaceae; Cryptococcus; Cryptococcus neoformans species complex; Cryptococcus neoformans; Cryptococcus neoformans var. grubii; Cryptococcus neoformans var. grubii H99;
contig_501	NCBI; cellular organisms; Eukaryota; Opisthokonta; Fungi; Dikarya; Basidiomycota; Agaricomycotina; Tremellomycetes; Tremellales; Cryptococcaceae; Cryptococcus; Cryptococcus neoformans species complex; Cryptococcus neoformans; Cryptococcus neoformans var. grubii; Cryptococcus neoformans var. grubii H99;
contig_509	NCBI; cellular organisms; Eukaryota; Opisthokonta; Fungi; Dikarya; Basidiomycota; Agaricomycotina; Tremellomycetes; Tremellales; Cryptococcaceae; Cryptococcus; Cryptococcus neoformans species complex; Cryptococcus neoformans; Cryptococcus neoformans var. grubii; Cryptococcus neoformans var. grubii H99;
contig_514	NCBI; cellular organisms; Eukaryota; Opisthokonta; Fungi; Dikarya; Basidiomycota; Agaricomycotina; Tremellomycetes; Tremellales; Cryptococcaceae; Cryptococcus; Cryptococcus neoformans species complex; Cryptococcus neoformans; Cryptococcus neoformans var. grubii; Cryptococcus neoformans var. grubii H99;
contig_517	NCBI; cellular organisms; Eukaryota; Opisthokonta; Fungi; Dikarya; Basidiomycota; Agaricomycotina; Tremellomycetes; Tremellales; Cryptococcaceae; Cryptococcus; Cryptococcus neoformans species complex; Cryptococcus neoformans; Cryptococcus neoformans var. grubii; Cryptococcus neoformans var. grubii H99;
contig_518	NCBI; cellular organisms; Eukaryota; Opisthokonta; Fungi; Dikarya; Basidiomycota; Agaricomycotina; Tremellomycetes; Tremellales; Cryptococcaceae; Cryptococcus; Cryptococcus neoformans species complex; Cryptococcus neoformans; Cryptococcus neoformans var. grubii; Cryptococcus neoformans var. grubii H99;
contig_520	NCBI; cellular organisms; Eukaryota; Opisthokonta; Fungi; Dikarya; Basidiomycota; Agaricomycotina; Tremellomycetes; Tremellales; Cryptococcaceae; Cryptococcus; Cryptococcus neoformans species complex; Cryptococcus neoformans; Cryptococcus neoformans var. grubii; Cryptococcus neoformans var. grubii H99;
contig_522	NCBI; cellular organisms; Eukaryota; Opisthokonta; Fungi; Dikarya; Basidiomycota; Agaricomycotina; Tremellomycetes; Tremellales; Cryptococcaceae; Cryptococcus; Cryptococcus neoformans species complex; Cryptococcus neoformans; Cryptococcus neoformans var. grubii; Cryptococcus neoformans var. grubii H99;
contig_524	NCBI; cellular organisms; Eukaryota; Opisthokonta; Fungi; Dikarya; Basidiomycota; Agaricomycotina; Tremellomycetes; Tremellales; Cryptococcaceae; Cryptococcus; Cryptococcus neoformans species complex; Cryptococcus neoformans; Cryptococcus neoformans var. grubii; Cryptococcus neoformans var. grubii H99;
contig_530	NCBI; cellular organisms; Eukaryota; Opisthokonta; Fungi; Dikarya; Basidiomycota; Agaricomycotina; Tremellomycetes; Tremellales; Cryptococcaceae; Cryptococcus; Cryptococcus neoformans species complex; Cryptococcus neoformans; Cryptococcus neoformans var. grubii; Cryptococcus neoformans var. grubii H99;
contig_532	NCBI; cellular organisms; Eukaryota; Opisthokonta; Fungi; Dikarya; Basidiomycota; Agaricomycotina; Tremellomycetes; Tremellales; Cryptococcaceae; Cryptococcus; Cryptococcus neoformans species complex; Cryptococcus neoformans; Cryptococcus neoformans var. grubii; Cryptococcus neoformans var. grubii H99;
contig_535	NCBI; cellular organisms; Eukaryota; Opisthokonta; Fungi; Dikarya; Basidiomycota; Agaricomycotina; Tremellomycetes; Tremellales; Cryptococcaceae; Cryptococcus; Cryptococcus neoformans species complex; Cryptococcus neoformans; Cryptococcus neoformans var. grubii; Cryptococcus neoformans var. grubii H99;
contig_537	NCBI; cellular organisms; Eukaryota; Opisthokonta; Fungi; Dikarya; Basidiomycota; Agaricomycotina; Tremellomycetes; Tremellales; Cryptococcaceae; Cryptococcus; Cryptococcus neoformans species complex; Cryptococcus neoformans; Cryptococcus neoformans var. grubii; Cryptococcus neoformans var. grubii H99;
contig_538	NCBI; cellular organisms; Eukaryota; Opisthokonta; Fungi; Dikarya; Basidiomycota; Agaricomycotina; Tremellomycetes; Tremellales; Cryptococcaceae; Cryptococcus; Cryptococcus neoformans species complex; Cryptococcus neoformans; Cryptococcus neoformans var. grubii; Cryptococcus neoformans var. grubii H99;
contig_542	NCBI; cellular organisms; Eukaryota; Opisthokonta; Fungi; Dikarya; Basidiomycota; Agaricomycotina; Tremellomycetes; Tremellales; Cryptococcaceae; Cryptococcus; Cryptococcus neoformans species complex; Cryptococcus neoformans; Cryptococcus neoformans var. grubii; Cryptococcus neoformans var. grubii H99;
contig_545	NCBI; cellular organisms; Eukaryota; Opisthokonta; Fungi; Dikarya; Basidiomycota; Agaricomycotina; Tremellomycetes; Tremellales; Cryptococcaceae; Cryptococcus; Cryptococcus neoformans species complex; Cryptococcus neoformans; Cryptococcus neoformans var. grubii; Cryptococcus neoformans var. grubii H99;
contig_551	NCBI; cellular organisms; Eukaryota; Opisthokonta; Fungi; Dikarya; Basidiomycota; Agaricomycotina; Tremellomycetes; Tremellales; Cryptococcaceae; Cryptococcus; Cryptococcus neoformans species complex; Cryptococcus neoformans; Cryptococcus neoformans var. grubii; Cryptococcus neoformans var. grubii H99;
contig_553	NCBI; cellular organisms; Eukaryota; Opisthokonta; Fungi; Dikarya; Basidiomycota; Agaricomycotina; Tremellomycetes; Tremellales; Cryptococcaceae; Cryptococcus; Cryptococcus neoformans species complex; Cryptococcus neoformans; Cryptococcus neoformans var. grubii; Cryptococcus neoformans var. grubii H99;
contig_560	NCBI; cellular organisms; Eukaryota; Opisthokonta; Fungi; Dikarya; Basidiomycota; Agaricomycotina; Tremellomycetes; Tremellales; Cryptococcaceae; Cryptococcus; Cryptococcus neoformans species complex; Cryptococcus neoformans; Cryptococcus neoformans var. grubii; Cryptococcus neoformans var. grubii H99;
contig_561	NCBI; cellular organisms; Eukaryota; Opisthokonta; Fungi; Dikarya; Basidiomycota; Agaricomycotina; Tremellomycetes; Tremellales; Cryptococcaceae; Cryptococcus; Cryptococcus neoformans species complex; Cryptococcus neoformans; Cryptococcus neoformans var. grubii; Cryptococcus neoformans var. grubii H99;
contig_563	NCBI; cellular organisms; Eukaryota; Opisthokonta; Fungi; Dikarya; Basidiomycota; Agaricomycotina; Tremellomycetes; Tremellales; Cryptococcaceae; Cryptococcus; Cryptococcus neoformans species complex; Cryptococcus neoformans; Cryptococcus neoformans var. grubii; Cryptococcus neoformans var. grubii H99;
contig_566	NCBI; cellular organisms; Eukaryota; Opisthokonta; Fungi; Dikarya; Basidiomycota; Agaricomycotina; Tremellomycetes; Tremellales; Cryptococcaceae; Cryptococcus; Cryptococcus neoformans species complex; Cryptococcus neoformans; Cryptococcus neoformans var. grubii; Cryptococcus neoformans var. grubii H99;
contig_568	NCBI; cellular organisms; Eukaryota; Opisthokonta; Fungi; Dikarya; Basidiomycota; Agaricomycotina; Tremellomycetes; Tremellales; Cryptococcaceae; Cryptococcus; Cryptococcus neoformans species complex; Cryptococcus neoformans; Cryptococcus neoformans var. grubii; Cryptococcus neoformans var. grubii H99;
contig_577	NCBI; cellular organisms; Eukaryota; Opisthokonta; Fungi; Dikarya; Basidiomycota; Agaricomycotina; Tremellomycetes; Tremellales; Cryptococcaceae; Cryptococcus; Cryptococcus neoformans species complex; Cryptococcus neoformans; Cryptococcus neoformans var. grubii; Cryptococcus neoformans var. grubii H99;
contig_578	NCBI; cellular organisms; Eukaryota; Opisthokonta; Fungi; Dikarya; Basidiomycota; Agaricomycotina; Tremellomycetes; Tremellales; Cryptococcaceae; Cryptococcus; Cryptococcus neoformans species complex; Cryptococcus neoformans; Cryptococcus neoformans var. grubii; Cryptococcus neoformans var. grubii H99;
contig_596	NCBI; cellular organisms; Eukaryota; Opisthokonta; Fungi; Dikarya; Basidiomycota; Agaricomycotina; Tremellomycetes; Tremellales; Cryptococcaceae; Cryptococcus; Cryptococcus neoformans species complex; Cryptococcus neoformans; Cryptococcus neoformans var. grubii; Cryptococcus neoformans var. grubii H99;
contig_601	NCBI; cellular organisms; Eukaryota; Opisthokonta; Fungi; Dikarya; Basidiomycota; Agaricomycotina; Tremellomycetes; Tremellales; Cryptococcaceae; Cryptococcus; Cryptococcus neoformans species complex; Cryptococcus neoformans; Cryptococcus neoformans var. grubii; Cryptococcus neoformans var. grubii H99;
contig_609	NCBI; cellular organisms; Eukaryota; Opisthokonta; Fungi; Dikarya; Basidiomycota; Agaricomycotina; Tremellomycetes; Tremellales; Cryptococcaceae; Cryptococcus; Cryptococcus neoformans species complex; Cryptococcus neoformans; Cryptococcus neoformans var. grubii; Cryptococcus neoformans var. grubii H99;
contig_610	NCBI; cellular organisms; Eukaryota; Opisthokonta; Fungi; Dikarya; Basidiomycota; Agaricomycotina; Tremellomycetes; Tremellales; Cryptococcaceae; Cryptococcus; Cryptococcus neoformans species complex; Cryptococcus neoformans; Cryptococcus neoformans var. grubii; Cryptococcus neoformans var. grubii H99;
contig_627	NCBI; cellular organisms; Eukaryota; Opisthokonta; Fungi; Dikarya; Basidiomycota; Agaricomycotina; Tremellomycetes; Tremellales; Cryptococcaceae; Cryptococcus; Cryptococcus neoformans species complex; Cryptococcus neoformans; Cryptococcus neoformans var. grubii; Cryptococcus neoformans var. grubii H99;
contig_628	NCBI; cellular organisms; Eukaryota; Opisthokonta; Fungi; Dikarya; Basidiomycota; Agaricomycotina; Tremellomycetes; Tremellales; Cryptococcaceae; Cryptococcus; Cryptococcus neoformans species complex; Cryptococcus neoformans; Cryptococcus neoformans var. grubii; Cryptococcus neoformans var. grubii H99;
contig_63	NCBI; cellular organisms; Eukaryota; Opisthokonta; Fungi; Dikarya; Basidiomycota; Agaricomycotina; Tremellomycetes; Tremellales; Cryptococcaceae; Cryptococcus; Cryptococcus neoformans species complex; Cryptococcus neoformans; Cryptococcus neoformans var. grubii; Cryptococcus neoformans var. grubii H99;
contig_632	NCBI; cellular organisms; Eukaryota; Opisthokonta; Fungi; Dikarya; Basidiomycota; Agaricomycotina; Tremellomycetes; Tremellales; Cryptococcaceae; Cryptococcus; Cryptococcus neoformans species complex; Cryptococcus neoformans; Cryptococcus neoformans var. grubii; Cryptococcus neoformans var. grubii H99;
contig_639	NCBI; cellular organisms; Eukaryota; Opisthokonta; Fungi; Dikarya; Basidiomycota; Agaricomycotina; Tremellomycetes; Tremellales; Cryptococcaceae; Cryptococcus; Cryptococcus neoformans species complex; Cryptococcus neoformans; Cryptococcus neoformans var. grubii; Cryptococcus neoformans var. grubii H99;
contig_643	NCBI; cellular organisms; Eukaryota; Opisthokonta; Fungi; Dikarya; Basidiomycota; Agaricomycotina; Tremellomycetes; Tremellales; Cryptococcaceae; Cryptococcus; Cryptococcus neoformans species complex; Cryptococcus neoformans; Cryptococcus neoformans var. grubii; Cryptococcus neoformans var. grubii H99;
contig_647	NCBI; cellular organisms; Eukaryota; Opisthokonta; Fungi; Dikarya; Basidiomycota; Agaricomycotina; Tremellomycetes; Tremellales; Cryptococcaceae; Cryptococcus; Cryptococcus neoformans species complex; Cryptococcus neoformans; Cryptococcus neoformans var. grubii; Cryptococcus neoformans var. grubii H99;
contig_656	NCBI; cellular organisms; Eukaryota; Opisthokonta; Fungi; Dikarya; Basidiomycota; Agaricomycotina; Tremellomycetes; Tremellales; Cryptococcaceae; Cryptococcus; Cryptococcus neoformans species complex; Cryptococcus neoformans; Cryptococcus neoformans var. grubii; Cryptococcus neoformans var. grubii H99;
contig_657	NCBI; cellular organisms; Eukaryota; Opisthokonta; Fungi; Dikarya; Basidiomycota; Agaricomycotina; Tremellomycetes; Tremellales; Cryptococcaceae; Cryptococcus; Cryptococcus neoformans species complex; Cryptococcus neoformans; Cryptococcus neoformans var. grubii; Cryptococcus neoformans var. grubii H99;
contig_66	NCBI; cellular organisms; Eukaryota; Opisthokonta; Fungi; Dikarya; Basidiomycota; Agaricomycotina; Tremellomycetes; Tremellales; Cryptococcaceae; Cryptococcus; Cryptococcus neoformans species complex; Cryptococcus neoformans; Cryptococcus neoformans var. grubii; Cryptococcus neoformans var. grubii H99;
contig_661	NCBI; cellular organisms; Eukaryota; Opisthokonta; Fungi; Dikarya; Basidiomycota; Agaricomycotina; Tremellomycetes; Tremellales; Cryptococcaceae; Cryptococcus; Cryptococcus neoformans species complex; Cryptococcus neoformans; Cryptococcus neoformans var. grubii; Cryptococcus neoformans var. grubii H99;
contig_662	NCBI; cellular organisms; Eukaryota; Opisthokonta; Fungi; Dikarya; Basidiomycota; Agaricomycotina; Tremellomycetes; Tremellales; Cryptococcaceae; Cryptococcus; Cryptococcus neoformans species complex; Cryptococcus neoformans; Cryptococcus neoformans var. grubii; Cryptococcus neoformans var. grubii H99;
contig_667	NCBI; cellular organisms; Eukaryota; Opisthokonta; Fungi; Dikarya; Basidiomycota; Agaricomycotina; Tremellomycetes; Tremellales; Cryptococcaceae; Cryptococcus; Cryptococcus neoformans species complex; Cryptococcus neoformans; Cryptococcus neoformans var. grubii; Cryptococcus neoformans var. grubii H99;
contig_670	NCBI; cellular organisms; Eukaryota; Opisthokonta; Fungi; Dikarya; Basidiomycota; Agaricomycotina; Tremellomycetes; Tremellales; Cryptococcaceae; Cryptococcus; Cryptococcus neoformans species complex; Cryptococcus neoformans; Cryptococcus neoformans var. grubii; Cryptococcus neoformans var. grubii H99;
contig_678	NCBI; cellular organisms; Eukaryota; Opisthokonta; Fungi; Dikarya; Basidiomycota; Agaricomycotina; Tremellomycetes; Tremellales; Cryptococcaceae; Cryptococcus; Cryptococcus neoformans species complex; Cryptococcus neoformans; Cryptococcus neoformans var. grubii; Cryptococcus neoformans var. grubii H99;
contig_684	NCBI; cellular organisms; Eukaryota; Opisthokonta; Fungi; Dikarya; Basidiomycota; Agaricomycotina; Tremellomycetes; Tremellales; Cryptococcaceae; Cryptococcus; Cryptococcus neoformans species complex; Cryptococcus neoformans; Cryptococcus neoformans var. grubii; Cryptococcus neoformans var. grubii H99;
contig_82	NCBI; cellular organisms; Eukaryota; Opisthokonta; Fungi; Dikarya; Basidiomycota; Agaricomycotina; Tremellomycetes; Tremellales; Cryptococcaceae; Cryptococcus; Cryptococcus neoformans species complex; Cryptococcus neoformans; Cryptococcus neoformans var. grubii; Cryptococcus neoformans var. grubii H99;
contig_88	NCBI; cellular organisms; Eukaryota; Opisthokonta; Fungi; Dikarya; Basidiomycota; Agaricomycotina; Tremellomycetes; Tremellales; Cryptococcaceae; Cryptococcus; Cryptococcus neoformans species complex; Cryptococcus neoformans; Cryptococcus neoformans var. grubii; Cryptococcus neoformans var. grubii H99;
contig_98	NCBI; cellular organisms; Eukaryota; Opisthokonta; Fungi; Dikarya; Basidiomycota; Agaricomycotina; Tremellomycetes; Tremellales; Cryptococcaceae; Cryptococcus; Cryptococcus neoformans species complex; Cryptococcus neoformans; Cryptococcus neoformans var. grubii; Cryptococcus neoformans var. grubii H99;
contig_17	NCBI; cellular organisms; Eukaryota; Opisthokonta; Fungi; Dikarya;
contig_164	NCBI; cellular organisms; Bacteria; Terrabacteria group; Firmicutes; Bacilli; Bacillales; Bacillaceae; Bacillus; Bacillus subtilis group; Bacillus subtilis; Bacillus subtilis subsp. spizizenii; Bacillus subtilis subsp. spizizenii ATCC 6633;
contig_16	NCBI; cellular organisms; Eukaryota; Opisthokonta; Fungi; Dikarya; Ascomycota; saccharomyceta; Saccharomycotina; Saccharomycetes; Saccharomycetales; Saccharomycetaceae; Saccharomyces; Saccharomyces cerevisiae; Saccharomyces cerevisiae YJM193;
contig_295	NCBI; cellular organisms; Eukaryota; Opisthokonta; Fungi; Dikarya; Ascomycota; saccharomyceta; Saccharomycotina; Saccharomycetes; Saccharomycetales; Saccharomycetaceae; Saccharomyces; Saccharomyces cerevisiae; Saccharomyces cerevisiae YJM270;
contig_223	NCBI; cellular organisms; Eukaryota; Opisthokonta; Fungi; Dikarya; Ascomycota; saccharomyceta; Saccharomycotina; Saccharomycetes; Saccharomycetales; Saccharomycetaceae; Saccharomyces; Saccharomyces cerevisiae; Saccharomyces cerevisiae YJM683;
contig_313	NCBI; cellular organisms; Eukaryota; Opisthokonta; Fungi; Dikarya; Ascomycota; saccharomyceta; Saccharomycotina; Saccharomycetes; Saccharomycetales; Saccharomycetaceae; Saccharomyces; Saccharomyces cerevisiae; Saccharomyces cerevisiae YJM1307;
contig_631	NCBI; cellular organisms; Eukaryota; Opisthokonta; Fungi; Dikarya; Ascomycota; saccharomyceta; Saccharomycotina; Saccharomycetes; Saccharomycetales; Saccharomycetaceae; Saccharomyces; Saccharomyces cerevisiae; Saccharomyces cerevisiae YJM1307;
contig_676	NCBI; cellular organisms; Eukaryota; Opisthokonta; Fungi; Dikarya; Ascomycota; saccharomyceta; Saccharomycotina; Saccharomycetes; Saccharomycetales; Saccharomycetaceae; Saccharomyces; Saccharomyces cerevisiae; Saccharomyces cerevisiae YJM1478;
